PokerStars Game #59890782578:  Hold'em No Limit ($3/$6 USD) - 2011/03/27 12:33:05 ET
Table 'Griseldis XI' 2-max Seat #2 is the button
Seat 1: fightingnuns ($300 in chips) 
Seat 2: mascom ($300 in chips) 
mascom: posts small blind $3
fightingnuns: posts big blind $6
*** HOLE CARDS ***
Dealt to fightingnuns [Jc Js]
mascom: raises $6 to $12
fightingnuns: raises $24 to $36
mascom: calls $24
*** FLOP *** [5s Kd 9s]
fightingnuns: checks 
mascom: checks 
*** TURN *** [5s Kd 9s] [Qc]
fightingnuns: checks 
mascom: bets $40
fightingnuns: calls $40
*** RIVER *** [5s Kd 9s Qc] [Qs]
fightingnuns: checks 
mascom: bets $100
fightingnuns: calls $100
*** SHOW DOWN ***
mascom: shows [6c 8h] (a pair of Queens)
fightingnuns: shows [Jc Js] (two pair, Queens and Jacks)
fightingnuns collected $351.50 from pot
*** SUMMARY ***
Total pot $352 | Rake $0.50 
Board [5s Kd 9s Qc Qs]
Seat 1: fightingnuns (big blind) showed [Jc Js] and won ($351.50) with two pair, Queens and Jacks
Seat 2: mascom (button) (small blind) showed [6c 8h] and lost with a pair of Queens



PokerStars Game #59890838717:  Hold'em No Limit ($3/$6 USD) - 2011/03/27 12:34:05 ET
Table 'Griseldis XI' 2-max Seat #1 is the button
Seat 1: fightingnuns ($475.50 in chips) 
Seat 2: mascom ($124 in chips) 
fightingnuns: posts small blind $3
mascom: posts big blind $6
*** HOLE CARDS ***
Dealt to fightingnuns [As Kc]
fightingnuns: raises $12 to $18
mascom: raises $36 to $54
fightingnuns: raises $421.50 to $475.50 and is all-in
mascom: calls $70 and is all-in
Uncalled bet ($351.50) returned to fightingnuns
*** FLOP *** [4s 7s 2c]
*** TURN *** [4s 7s 2c] [Th]
*** RIVER *** [4s 7s 2c Th] [Qc]
*** SHOW DOWN ***
mascom: shows [Ts Ks] (a pair of Tens)
fightingnuns: shows [As Kc] (high card Ace)
mascom collected $247.50 from pot
*** SUMMARY ***
Total pot $248 | Rake $0.50 
Board [4s 7s 2c Th Qc]
Seat 1: fightingnuns (button) (small blind) showed [As Kc] and lost with high card Ace
Seat 2: mascom (big blind) showed [Ts Ks] and won ($247.50) with a pair of Tens



PokerStars Game #59890863015:  Hold'em No Limit ($3/$6 USD) - 2011/03/27 12:34:31 ET
Table 'Griseldis XI' 2-max Seat #2 is the button
Seat 1: fightingnuns ($351.50 in chips) 
Seat 2: mascom ($247.50 in chips) 
mascom: posts small blind $3
fightingnuns: posts big blind $6
*** HOLE CARDS ***
Dealt to fightingnuns [Qs 6s]
mascom: raises $6 to $12
fightingnuns: folds 
Uncalled bet ($6) returned to mascom
mascom collected $12 from pot
*** SUMMARY ***
Total pot $12 | Rake $0 
Seat 1: fightingnuns (big blind) folded before Flop
Seat 2: mascom (button) (small blind) collected ($12)



PokerStars Game #59890870468:  Hold'em No Limit ($3/$6 USD) - 2011/03/27 12:34:39 ET
Table 'Griseldis XI' 2-max Seat #1 is the button
Seat 1: fightingnuns ($345.50 in chips) 
Seat 2: mascom ($253.50 in chips) 
fightingnuns: posts small blind $3
mascom: posts big blind $6
*** HOLE CARDS ***
Dealt to fightingnuns [Th 8d]
fightingnuns: raises $6 to $12
mascom: raises $24 to $36
fightingnuns: folds 
Uncalled bet ($24) returned to mascom
mascom collected $24 from pot
*** SUMMARY ***
Total pot $24 | Rake $0 
Seat 1: fightingnuns (button) (small blind) folded before Flop
Seat 2: mascom (big blind) collected ($24)



PokerStars Game #59890884525:  Hold'em No Limit ($3/$6 USD) - 2011/03/27 12:34:54 ET
Table 'Griseldis XI' 2-max Seat #2 is the button
Seat 1: fightingnuns ($333.50 in chips) 
Seat 2: mascom ($265.50 in chips) 
mascom: posts small blind $3
fightingnuns: posts big blind $6
*** HOLE CARDS ***
Dealt to fightingnuns [7h Tc]
mascom: raises $6 to $12
fightingnuns: folds 
Uncalled bet ($6) returned to mascom
mascom collected $12 from pot
*** SUMMARY ***
Total pot $12 | Rake $0 
Seat 1: fightingnuns (big blind) folded before Flop
Seat 2: mascom (button) (small blind) collected ($12)



PokerStars Game #59890894319:  Hold'em No Limit ($3/$6 USD) - 2011/03/27 12:35:04 ET
Table 'Griseldis XI' 2-max Seat #1 is the button
Seat 1: fightingnuns ($327.50 in chips) 
Seat 2: mascom ($271.50 in chips) 
fightingnuns: posts small blind $3
mascom: posts big blind $6
*** HOLE CARDS ***
Dealt to fightingnuns [3h 9c]
fightingnuns: folds 
Uncalled bet ($3) returned to mascom
mascom collected $6 from pot
*** SUMMARY ***
Total pot $6 | Rake $0 
Seat 1: fightingnuns (button) (small blind) folded before Flop
Seat 2: mascom (big blind) collected ($6)



PokerStars Game #59890902963:  Hold'em No Limit ($3/$6 USD) - 2011/03/27 12:35:13 ET
Table 'Griseldis XI' 2-max Seat #2 is the button
Seat 1: fightingnuns ($324.50 in chips) 
Seat 2: mascom ($274.50 in chips) 
mascom: posts small blind $3
fightingnuns: posts big blind $6
*** HOLE CARDS ***
Dealt to fightingnuns [5c Kd]
mascom: raises $6 to $12
fightingnuns: folds 
Uncalled bet ($6) returned to mascom
mascom collected $12 from pot
*** SUMMARY ***
Total pot $12 | Rake $0 
Seat 1: fightingnuns (big blind) folded before Flop
Seat 2: mascom (button) (small blind) collected ($12)



PokerStars Game #59890910834:  Hold'em No Limit ($3/$6 USD) - 2011/03/27 12:35:22 ET
Table 'Griseldis XI' 2-max Seat #1 is the button
Seat 1: fightingnuns ($318.50 in chips) 
Seat 2: mascom ($280.50 in chips) 
fightingnuns: posts small blind $3
mascom: posts big blind $6
*** HOLE CARDS ***
Dealt to fightingnuns [Jd 4d]
fightingnuns: raises $6 to $12
mascom: raises $24 to $36
fightingnuns: folds 
Uncalled bet ($24) returned to mascom
mascom collected $24 from pot
*** SUMMARY ***
Total pot $24 | Rake $0 
Seat 1: fightingnuns (button) (small blind) folded before Flop
Seat 2: mascom (big blind) collected ($24)



PokerStars Game #59890922996:  Hold'em No Limit ($3/$6 USD) - 2011/03/27 12:35:35 ET
Table 'Griseldis XI' 2-max Seat #2 is the button
Seat 1: fightingnuns ($306.50 in chips) 
Seat 2: mascom ($292.50 in chips) 
mascom: posts small blind $3
fightingnuns: posts big blind $6
*** HOLE CARDS ***
Dealt to fightingnuns [3s 9c]
mascom: raises $6 to $12
fightingnuns: folds 
Uncalled bet ($6) returned to mascom
mascom collected $12 from pot
*** SUMMARY ***
Total pot $12 | Rake $0 
Seat 1: fightingnuns (big blind) folded before Flop
Seat 2: mascom (button) (small blind) collected ($12)



PokerStars Game #59890933731:  Hold'em No Limit ($3/$6 USD) - 2011/03/27 12:35:46 ET
Table 'Griseldis XI' 2-max Seat #1 is the button
Seat 1: fightingnuns ($300.50 in chips) 
Seat 2: mascom ($298.50 in chips) 
fightingnuns: posts small blind $3
mascom: posts big blind $6
*** HOLE CARDS ***
Dealt to fightingnuns [Kd 6h]
fightingnuns: folds 
Uncalled bet ($3) returned to mascom
mascom collected $6 from pot
*** SUMMARY ***
Total pot $6 | Rake $0 
Seat 1: fightingnuns (button) (small blind) folded before Flop
Seat 2: mascom (big blind) collected ($6)



PokerStars Game #59890940008:  Hold'em No Limit ($3/$6 USD) - 2011/03/27 12:35:53 ET
Table 'Griseldis XI' 2-max Seat #2 is the button
Seat 1: fightingnuns ($300 in chips) 
Seat 2: mascom ($301.50 in chips) 
mascom: posts small blind $3
fightingnuns: posts big blind $6
*** HOLE CARDS ***
Dealt to fightingnuns [Qd Js]
mascom: folds 
Uncalled bet ($3) returned to fightingnuns
fightingnuns collected $6 from pot
fightingnuns: doesn't show hand 
*** SUMMARY ***
Total pot $6 | Rake $0 
Seat 1: fightingnuns (big blind) collected ($6)
Seat 2: mascom (button) (small blind) folded before Flop



PokerStars Game #59890948983:  Hold'em No Limit ($3/$6 USD) - 2011/03/27 12:36:03 ET
Table 'Griseldis XI' 2-max Seat #1 is the button
Seat 1: fightingnuns ($303 in chips) 
Seat 2: mascom ($298.50 in chips) 
fightingnuns: posts small blind $3
mascom: posts big blind $6
*** HOLE CARDS ***
Dealt to fightingnuns [7c Qh]
fightingnuns: raises $6 to $12
mascom: raises $24 to $36
fightingnuns: folds 
Uncalled bet ($24) returned to mascom
mascom collected $24 from pot
*** SUMMARY ***
Total pot $24 | Rake $0 
Seat 1: fightingnuns (button) (small blind) folded before Flop
Seat 2: mascom (big blind) collected ($24)



PokerStars Game #59890967761:  Hold'em No Limit ($3/$6 USD) - 2011/03/27 12:36:23 ET
Table 'Griseldis XI' 2-max Seat #2 is the button
Seat 1: fightingnuns ($300 in chips) 
Seat 2: mascom ($310.50 in chips) 
mascom: posts small blind $3
fightingnuns: posts big blind $6
*** HOLE CARDS ***
Dealt to fightingnuns [4c 8s]
mascom: raises $6 to $12
fightingnuns: folds 
Uncalled bet ($6) returned to mascom
mascom collected $12 from pot
*** SUMMARY ***
Total pot $12 | Rake $0 
Seat 1: fightingnuns (big blind) folded before Flop
Seat 2: mascom (button) (small blind) collected ($12)



PokerStars Game #59890976932:  Hold'em No Limit ($3/$6 USD) - 2011/03/27 12:36:32 ET
Table 'Griseldis XI' 2-max Seat #1 is the button
Seat 1: fightingnuns ($300 in chips) 
Seat 2: mascom ($316.50 in chips) 
fightingnuns: posts small blind $3
mascom: posts big blind $6
*** HOLE CARDS ***
Dealt to fightingnuns [8s Kc]
fightingnuns: raises $6 to $12
mascom: folds 
Uncalled bet ($6) returned to fightingnuns
fightingnuns collected $12 from pot
fightingnuns: doesn't show hand 
*** SUMMARY ***
Total pot $12 | Rake $0 
Seat 1: fightingnuns (button) (small blind) collected ($12)
Seat 2: mascom (big blind) folded before Flop



PokerStars Game #59890985730:  Hold'em No Limit ($3/$6 USD) - 2011/03/27 12:36:42 ET
Table 'Griseldis XI' 2-max Seat #2 is the button
Seat 1: fightingnuns ($306 in chips) 
Seat 2: mascom ($310.50 in chips) 
mascom: posts small blind $3
fightingnuns: posts big blind $6
*** HOLE CARDS ***
Dealt to fightingnuns [5c Ac]
mascom: raises $6 to $12
fightingnuns: calls $6
*** FLOP *** [7d 2d 3h]
fightingnuns: checks 
mascom: bets $12
fightingnuns: calls $12
*** TURN *** [7d 2d 3h] [8s]
fightingnuns: checks 
mascom: bets $33
fightingnuns: folds 
Uncalled bet ($33) returned to mascom
mascom collected $47.50 from pot
*** SUMMARY ***
Total pot $48 | Rake $0.50 
Board [7d 2d 3h 8s]
Seat 1: fightingnuns (big blind) folded on the Turn
Seat 2: mascom (button) (small blind) collected ($47.50)



PokerStars Game #59891024617:  Hold'em No Limit ($3/$6 USD) - 2011/03/27 12:37:23 ET
Table 'Griseldis XI' 2-max Seat #1 is the button
Seat 1: fightingnuns ($300 in chips) 
Seat 2: mascom ($334 in chips) 
fightingnuns: posts small blind $3
mascom: posts big blind $6
*** HOLE CARDS ***
Dealt to fightingnuns [Qc Qd]
fightingnuns: raises $6 to $12
mascom: calls $6
*** FLOP *** [9s 3d 3h]
mascom: bets $12
fightingnuns: raises $18 to $30
mascom: folds 
Uncalled bet ($18) returned to fightingnuns
fightingnuns collected $47.50 from pot
fightingnuns: doesn't show hand 
*** SUMMARY ***
Total pot $48 | Rake $0.50 
Board [9s 3d 3h]
Seat 1: fightingnuns (button) (small blind) collected ($47.50)
Seat 2: mascom (big blind) folded on the Flop



PokerStars Game #59891050051:  Hold'em No Limit ($3/$6 USD) - 2011/03/27 12:37:50 ET
Table 'Griseldis XI' 2-max Seat #2 is the button
Seat 1: fightingnuns ($323.50 in chips) 
Seat 2: mascom ($310 in chips) 
mascom: posts small blind $3
fightingnuns: posts big blind $6
*** HOLE CARDS ***
Dealt to fightingnuns [Qh 9h]
mascom: raises $6 to $12
fightingnuns: calls $6
*** FLOP *** [Tc 8c 7h]
fightingnuns: bets $18
mascom: calls $18
*** TURN *** [Tc 8c 7h] [As]
fightingnuns: checks 
mascom: bets $33
fightingnuns: folds 
Uncalled bet ($33) returned to mascom
mascom collected $59.50 from pot
*** SUMMARY ***
Total pot $60 | Rake $0.50 
Board [Tc 8c 7h As]
Seat 1: fightingnuns (big blind) folded on the Turn
Seat 2: mascom (button) (small blind) collected ($59.50)



PokerStars Game #59891080329:  Hold'em No Limit ($3/$6 USD) - 2011/03/27 12:38:23 ET
Table 'Griseldis XI' 2-max Seat #1 is the button
Seat 1: fightingnuns ($300 in chips) 
Seat 2: mascom ($339.50 in chips) 
fightingnuns: posts small blind $3
mascom: posts big blind $6
*** HOLE CARDS ***
Dealt to fightingnuns [Ad 8s]
fightingnuns: raises $6 to $12
mascom: folds 
Uncalled bet ($6) returned to fightingnuns
fightingnuns collected $12 from pot
fightingnuns: doesn't show hand 
*** SUMMARY ***
Total pot $12 | Rake $0 
Seat 1: fightingnuns (button) (small blind) collected ($12)
Seat 2: mascom (big blind) folded before Flop



PokerStars Game #59891087711:  Hold'em No Limit ($3/$6 USD) - 2011/03/27 12:38:31 ET
Table 'Griseldis XI' 2-max Seat #2 is the button
Seat 1: fightingnuns ($306 in chips) 
Seat 2: mascom ($333.50 in chips) 
mascom: posts small blind $3
fightingnuns: posts big blind $6
*** HOLE CARDS ***
Dealt to fightingnuns [5h Ks]
mascom: raises $6 to $12
fightingnuns: folds 
Uncalled bet ($6) returned to mascom
mascom collected $12 from pot
*** SUMMARY ***
Total pot $12 | Rake $0 
Seat 1: fightingnuns (big blind) folded before Flop
Seat 2: mascom (button) (small blind) collected ($12)



PokerStars Game #59891105502:  Hold'em No Limit ($3/$6 USD) - 2011/03/27 12:38:50 ET
Table 'Griseldis XI' 2-max Seat #1 is the button
Seat 1: fightingnuns ($300 in chips) 
Seat 2: mascom ($339.50 in chips) 
fightingnuns: posts small blind $3
mascom: posts big blind $6
*** HOLE CARDS ***
Dealt to fightingnuns [2s 3c]
fightingnuns: folds 
Uncalled bet ($3) returned to mascom
mascom collected $6 from pot
*** SUMMARY ***
Total pot $6 | Rake $0 
Seat 1: fightingnuns (button) (small blind) folded before Flop
Seat 2: mascom (big blind) collected ($6)



PokerStars Game #59891112976:  Hold'em No Limit ($3/$6 USD) - 2011/03/27 12:38:58 ET
Table 'Griseldis XI' 2-max Seat #2 is the button
Seat 1: fightingnuns ($300 in chips) 
Seat 2: mascom ($342.50 in chips) 
mascom: posts small blind $3
fightingnuns: posts big blind $6
*** HOLE CARDS ***
Dealt to fightingnuns [9c 5d]
mascom: raises $6 to $12
fightingnuns: folds 
Uncalled bet ($6) returned to mascom
mascom collected $12 from pot
*** SUMMARY ***
Total pot $12 | Rake $0 
Seat 1: fightingnuns (big blind) folded before Flop
Seat 2: mascom (button) (small blind) collected ($12)



PokerStars Game #59891129785:  Hold'em No Limit ($3/$6 USD) - 2011/03/27 12:39:16 ET
Table 'Griseldis XI' 2-max Seat #1 is the button
Seat 1: fightingnuns ($300 in chips) 
Seat 2: mascom ($348.50 in chips) 
fightingnuns: posts small blind $3
mascom: posts big blind $6
*** HOLE CARDS ***
Dealt to fightingnuns [7h Ah]
fightingnuns: raises $6 to $12
mascom: folds 
Uncalled bet ($6) returned to fightingnuns
fightingnuns collected $12 from pot
fightingnuns: doesn't show hand 
*** SUMMARY ***
Total pot $12 | Rake $0 
Seat 1: fightingnuns (button) (small blind) collected ($12)
Seat 2: mascom (big blind) folded before Flop



PokerStars Game #59891137653:  Hold'em No Limit ($3/$6 USD) - 2011/03/27 12:39:25 ET
Table 'Griseldis XI' 2-max Seat #2 is the button
Seat 1: fightingnuns ($306 in chips) 
Seat 2: mascom ($342.50 in chips) 
mascom: posts small blind $3
fightingnuns: posts big blind $6
*** HOLE CARDS ***
Dealt to fightingnuns [3s 5s]
mascom: raises $6 to $12
fightingnuns: folds 
Uncalled bet ($6) returned to mascom
mascom collected $12 from pot
*** SUMMARY ***
Total pot $12 | Rake $0 
Seat 1: fightingnuns (big blind) folded before Flop
Seat 2: mascom (button) (small blind) collected ($12)



PokerStars Game #59891148510:  Hold'em No Limit ($3/$6 USD) - 2011/03/27 12:39:37 ET
Table 'Griseldis XI' 2-max Seat #1 is the button
Seat 1: fightingnuns ($300 in chips) 
Seat 2: mascom ($348.50 in chips) 
fightingnuns: posts small blind $3
mascom: posts big blind $6
*** HOLE CARDS ***
Dealt to fightingnuns [9c 5h]
fightingnuns: folds 
Uncalled bet ($3) returned to mascom
mascom collected $6 from pot
*** SUMMARY ***
Total pot $6 | Rake $0 
Seat 1: fightingnuns (button) (small blind) folded before Flop
Seat 2: mascom (big blind) collected ($6)



PokerStars Game #59891153945:  Hold'em No Limit ($3/$6 USD) - 2011/03/27 12:39:42 ET
Table 'Griseldis XI' 2-max Seat #2 is the button
Seat 1: fightingnuns ($300 in chips) 
Seat 2: mascom ($351.50 in chips) 
mascom: posts small blind $3
fightingnuns: posts big blind $6
*** HOLE CARDS ***
Dealt to fightingnuns [3d Ad]
mascom: raises $6 to $12
fightingnuns: calls $6
*** FLOP *** [9h Kc Ah]
fightingnuns: checks 
mascom: bets $12
fightingnuns: calls $12
*** TURN *** [9h Kc Ah] [2c]
fightingnuns: checks 
mascom: checks 
*** RIVER *** [9h Kc Ah 2c] [7s]
fightingnuns: checks 
mascom: checks 
*** SHOW DOWN ***
fightingnuns: shows [3d Ad] (a pair of Aces)
mascom: mucks hand 
fightingnuns collected $47.50 from pot
*** SUMMARY ***
Total pot $48 | Rake $0.50 
Board [9h Kc Ah 2c 7s]
Seat 1: fightingnuns (big blind) showed [3d Ad] and won ($47.50) with a pair of Aces
Seat 2: mascom (button) (small blind) mucked [Qc Js]



PokerStars Game #59891185379:  Hold'em No Limit ($3/$6 USD) - 2011/03/27 12:40:16 ET
Table 'Griseldis XI' 2-max Seat #1 is the button
Seat 1: fightingnuns ($323.50 in chips) 
Seat 2: mascom ($327.50 in chips) 
fightingnuns: posts small blind $3
mascom: posts big blind $6
*** HOLE CARDS ***
Dealt to fightingnuns [5h Ks]
fightingnuns: raises $6 to $12
mascom: calls $6
*** FLOP *** [Ac Qh 7h]
mascom: bets $12
fightingnuns: folds 
Uncalled bet ($12) returned to mascom
mascom collected $23.50 from pot
*** SUMMARY ***
Total pot $24 | Rake $0.50 
Board [Ac Qh 7h]
Seat 1: fightingnuns (button) (small blind) folded on the Flop
Seat 2: mascom (big blind) collected ($23.50)



PokerStars Game #59891206073:  Hold'em No Limit ($3/$6 USD) - 2011/03/27 12:40:38 ET
Table 'Griseldis XI' 2-max Seat #2 is the button
Seat 1: fightingnuns ($311.50 in chips) 
Seat 2: mascom ($339 in chips) 
mascom: posts small blind $3
fightingnuns: posts big blind $6
*** HOLE CARDS ***
Dealt to fightingnuns [7s Kh]
mascom: raises $6 to $12
fightingnuns: calls $6
*** FLOP *** [2h 5c 3h]
fightingnuns: checks 
mascom: bets $12
fightingnuns: calls $12
*** TURN *** [2h 5c 3h] [Qs]
fightingnuns: checks 
mascom: bets $33
fightingnuns: raises $63 to $96
mascom: folds 
Uncalled bet ($63) returned to fightingnuns
fightingnuns collected $113.50 from pot
fightingnuns: doesn't show hand 
*** SUMMARY ***
Total pot $114 | Rake $0.50 
Board [2h 5c 3h Qs]
Seat 1: fightingnuns (big blind) collected ($113.50)
Seat 2: mascom (button) (small blind) folded on the Turn



PokerStars Game #59891239512:  Hold'em No Limit ($3/$6 USD) - 2011/03/27 12:41:13 ET
Table 'Griseldis XI' 2-max Seat #1 is the button
Seat 1: fightingnuns ($368 in chips) 
Seat 2: mascom ($282 in chips) 
fightingnuns: posts small blind $3
mascom: posts big blind $6
*** HOLE CARDS ***
Dealt to fightingnuns [3h Ad]
fightingnuns: raises $6 to $12
mascom: folds 
Uncalled bet ($6) returned to fightingnuns
fightingnuns collected $12 from pot
fightingnuns: doesn't show hand 
*** SUMMARY ***
Total pot $12 | Rake $0 
Seat 1: fightingnuns (button) (small blind) collected ($12)
Seat 2: mascom (big blind) folded before Flop



PokerStars Game #59891246829:  Hold'em No Limit ($3/$6 USD) - 2011/03/27 12:41:21 ET
Table 'Griseldis XI' 2-max Seat #2 is the button
Seat 1: fightingnuns ($374 in chips) 
Seat 2: mascom ($276 in chips) 
mascom: posts small blind $3
fightingnuns: posts big blind $6
*** HOLE CARDS ***
Dealt to fightingnuns [Ah As]
mascom: raises $6 to $12
fightingnuns: raises $24 to $36
mascom: calls $24
*** FLOP *** [5h Ad Jh]
fightingnuns: checks 
mascom: bets $25
fightingnuns: calls $25
*** TURN *** [5h Ad Jh] [Kc]
fightingnuns: bets $54
mascom: folds 
Uncalled bet ($54) returned to fightingnuns
fightingnuns collected $121.50 from pot
fightingnuns: doesn't show hand 
*** SUMMARY ***
Total pot $122 | Rake $0.50 
Board [5h Ad Jh Kc]
Seat 1: fightingnuns (big blind) collected ($121.50)
Seat 2: mascom (button) (small blind) folded on the Turn



PokerStars Game #59891290314:  Hold'em No Limit ($3/$6 USD) - 2011/03/27 12:42:08 ET
Table 'Griseldis XI' 2-max Seat #1 is the button
Seat 1: fightingnuns ($434.50 in chips) 
Seat 2: mascom ($215 in chips) 
fightingnuns: posts small blind $3
mascom: posts big blind $6
*** HOLE CARDS ***
Dealt to fightingnuns [Qh 7d]
fightingnuns: raises $6 to $12
mascom: folds 
Uncalled bet ($6) returned to fightingnuns
fightingnuns collected $12 from pot
fightingnuns: doesn't show hand 
*** SUMMARY ***
Total pot $12 | Rake $0 
Seat 1: fightingnuns (button) (small blind) collected ($12)
Seat 2: mascom (big blind) folded before Flop



PokerStars Game #59891300545:  Hold'em No Limit ($3/$6 USD) - 2011/03/27 12:42:19 ET
Table 'Griseldis XI' 2-max Seat #2 is the button
Seat 1: fightingnuns ($440.50 in chips) 
Seat 2: mascom ($209 in chips) 
mascom: posts small blind $3
fightingnuns: posts big blind $6
*** HOLE CARDS ***
Dealt to fightingnuns [Ah 7d]
mascom: folds 
Uncalled bet ($3) returned to fightingnuns
fightingnuns collected $6 from pot
fightingnuns: doesn't show hand 
*** SUMMARY ***
Total pot $6 | Rake $0 
Seat 1: fightingnuns (big blind) collected ($6)
Seat 2: mascom (button) (small blind) folded before Flop



PokerStars Game #59891307707:  Hold'em No Limit ($3/$6 USD) - 2011/03/27 12:42:26 ET
Table 'Griseldis XI' 2-max Seat #1 is the button
Seat 1: fightingnuns ($443.50 in chips) 
Seat 2: mascom ($206 in chips) 
fightingnuns: posts small blind $3
mascom: posts big blind $6
*** HOLE CARDS ***
Dealt to fightingnuns [5s 7c]
fightingnuns: folds 
Uncalled bet ($3) returned to mascom
mascom collected $6 from pot
*** SUMMARY ***
Total pot $6 | Rake $0 
Seat 1: fightingnuns (button) (small blind) folded before Flop
Seat 2: mascom (big blind) collected ($6)



PokerStars Game #59891313281:  Hold'em No Limit ($3/$6 USD) - 2011/03/27 12:42:32 ET
Table 'Griseldis XI' 2-max Seat #2 is the button
Seat 1: fightingnuns ($440.50 in chips) 
Seat 2: mascom ($209 in chips) 
mascom: posts small blind $3
fightingnuns: posts big blind $6
*** HOLE CARDS ***
Dealt to fightingnuns [2c Qs]
mascom: raises $6 to $12
fightingnuns: folds 
Uncalled bet ($6) returned to mascom
mascom collected $12 from pot
*** SUMMARY ***
Total pot $12 | Rake $0 
Seat 1: fightingnuns (big blind) folded before Flop
Seat 2: mascom (button) (small blind) collected ($12)



PokerStars Game #59891323759:  Hold'em No Limit ($3/$6 USD) - 2011/03/27 12:42:43 ET
Table 'Griseldis XI' 2-max Seat #1 is the button
Seat 1: fightingnuns ($434.50 in chips) 
Seat 2: mascom ($215 in chips) 
fightingnuns: posts small blind $3
mascom: posts big blind $6
*** HOLE CARDS ***
Dealt to fightingnuns [Th 4d]
fightingnuns: folds 
Uncalled bet ($3) returned to mascom
mascom collected $6 from pot
*** SUMMARY ***
Total pot $6 | Rake $0 
Seat 1: fightingnuns (button) (small blind) folded before Flop
Seat 2: mascom (big blind) collected ($6)



PokerStars Game #59891329296:  Hold'em No Limit ($3/$6 USD) - 2011/03/27 12:42:49 ET
Table 'Griseldis XI' 2-max Seat #2 is the button
Seat 1: fightingnuns ($431.50 in chips) 
Seat 2: mascom ($218 in chips) 
mascom: posts small blind $3
fightingnuns: posts big blind $6
*** HOLE CARDS ***
Dealt to fightingnuns [3h 8h]
mascom: raises $6 to $12
fightingnuns: folds 
Uncalled bet ($6) returned to mascom
mascom collected $12 from pot
*** SUMMARY ***
Total pot $12 | Rake $0 
Seat 1: fightingnuns (big blind) folded before Flop
Seat 2: mascom (button) (small blind) collected ($12)



PokerStars Game #59891338764:  Hold'em No Limit ($3/$6 USD) - 2011/03/27 12:43:00 ET
Table 'Griseldis XI' 2-max Seat #1 is the button
Seat 1: fightingnuns ($425.50 in chips) 
Seat 2: mascom ($224 in chips) 
fightingnuns: posts small blind $3
mascom: posts big blind $6
*** HOLE CARDS ***
Dealt to fightingnuns [2h 3c]
fightingnuns: folds 
Uncalled bet ($3) returned to mascom
mascom collected $6 from pot
*** SUMMARY ***
Total pot $6 | Rake $0 
Seat 1: fightingnuns (button) (small blind) folded before Flop
Seat 2: mascom (big blind) collected ($6)



PokerStars Game #59891344684:  Hold'em No Limit ($3/$6 USD) - 2011/03/27 12:43:06 ET
Table 'Griseldis XI' 2-max Seat #2 is the button
Seat 1: fightingnuns ($422.50 in chips) 
Seat 2: mascom ($227 in chips) 
mascom: posts small blind $3
fightingnuns: posts big blind $6
*** HOLE CARDS ***
Dealt to fightingnuns [Qc Th]
mascom: raises $6 to $12
fightingnuns: raises $24 to $36
mascom: folds 
Uncalled bet ($24) returned to fightingnuns
fightingnuns collected $24 from pot
fightingnuns: doesn't show hand 
*** SUMMARY ***
Total pot $24 | Rake $0 
Seat 1: fightingnuns (big blind) collected ($24)
Seat 2: mascom (button) (small blind) folded before Flop



PokerStars Game #59891366588:  Hold'em No Limit ($3/$6 USD) - 2011/03/27 12:43:29 ET
Table 'Griseldis XI' 2-max Seat #1 is the button
Seat 1: fightingnuns ($434.50 in chips) 
Seat 2: mascom ($215 in chips) 
fightingnuns: posts small blind $3
mascom: posts big blind $6
*** HOLE CARDS ***
Dealt to fightingnuns [Kd 2d]
fightingnuns: raises $6 to $12
mascom: calls $6
*** FLOP *** [7h As 3h]
mascom: bets $12
fightingnuns: raises $24 to $36
mascom: raises $63 to $99
fightingnuns: folds 
Uncalled bet ($63) returned to mascom
mascom collected $95.50 from pot
*** SUMMARY ***
Total pot $96 | Rake $0.50 
Board [7h As 3h]
Seat 1: fightingnuns (button) (small blind) folded on the Flop
Seat 2: mascom (big blind) collected ($95.50)



PokerStars Game #59891396300:  Hold'em No Limit ($3/$6 USD) - 2011/03/27 12:44:01 ET
Table 'Griseldis XI' 2-max Seat #2 is the button
Seat 1: fightingnuns ($386.50 in chips) 
Seat 2: mascom ($262.50 in chips) 
mascom: posts small blind $3
fightingnuns: posts big blind $6
*** HOLE CARDS ***
Dealt to fightingnuns [3s As]
mascom: raises $6 to $12
fightingnuns: calls $6
*** FLOP *** [3c Jh 8d]
fightingnuns: checks 
mascom: bets $12
fightingnuns: calls $12
*** TURN *** [3c Jh 8d] [4h]
fightingnuns: checks 
mascom: bets $25
fightingnuns: calls $25
*** RIVER *** [3c Jh 8d 4h] [3h]
fightingnuns: checks 
mascom: checks 
*** SHOW DOWN ***
fightingnuns: shows [3s As] (three of a kind, Threes)
mascom: mucks hand 
fightingnuns collected $97.50 from pot
*** SUMMARY ***
Total pot $98 | Rake $0.50 
Board [3c Jh 8d 4h 3h]
Seat 1: fightingnuns (big blind) showed [3s As] and won ($97.50) with three of a kind, Threes
Seat 2: mascom (button) (small blind) mucked [Kc 8c]



PokerStars Game #59891431916:  Hold'em No Limit ($3/$6 USD) - 2011/03/27 12:44:39 ET
Table 'Griseldis XI' 2-max Seat #1 is the button
Seat 1: fightingnuns ($435 in chips) 
Seat 2: mascom ($213.50 in chips) 
fightingnuns: posts small blind $3
mascom: posts big blind $6
*** HOLE CARDS ***
Dealt to fightingnuns [Qh 3h]
fightingnuns: raises $6 to $12
mascom: folds 
Uncalled bet ($6) returned to fightingnuns
fightingnuns collected $12 from pot
fightingnuns: doesn't show hand 
*** SUMMARY ***
Total pot $12 | Rake $0 
Seat 1: fightingnuns (button) (small blind) collected ($12)
Seat 2: mascom (big blind) folded before Flop



PokerStars Game #59891444223:  Hold'em No Limit ($3/$6 USD) - 2011/03/27 12:44:52 ET
Table 'Griseldis XI' 2-max Seat #2 is the button
Seat 1: fightingnuns ($441 in chips) 
Seat 2: mascom ($207.50 in chips) 
mascom: posts small blind $3
fightingnuns: posts big blind $6
*** HOLE CARDS ***
Dealt to fightingnuns [8h Td]
mascom: raises $6 to $12
fightingnuns: calls $6
*** FLOP *** [4c Qh 7d]
fightingnuns: checks 
mascom: bets $12
fightingnuns: folds 
Uncalled bet ($12) returned to mascom
mascom collected $23.50 from pot
*** SUMMARY ***
Total pot $24 | Rake $0.50 
Board [4c Qh 7d]
Seat 1: fightingnuns (big blind) folded on the Flop
Seat 2: mascom (button) (small blind) collected ($23.50)



PokerStars Game #59891461290:  Hold'em No Limit ($3/$6 USD) - 2011/03/27 12:45:09 ET
Table 'Griseldis XI' 2-max Seat #1 is the button
Seat 1: fightingnuns ($429 in chips) 
Seat 2: mascom ($219 in chips) 
fightingnuns: posts small blind $3
mascom: posts big blind $6
*** HOLE CARDS ***
Dealt to fightingnuns [2d Kd]
fightingnuns: raises $6 to $12
mascom: calls $6
*** FLOP *** [4h Qs 8s]
mascom: bets $12
fightingnuns: folds 
Uncalled bet ($12) returned to mascom
mascom collected $23.50 from pot
*** SUMMARY ***
Total pot $24 | Rake $0.50 
Board [4h Qs 8s]
Seat 1: fightingnuns (button) (small blind) folded on the Flop
Seat 2: mascom (big blind) collected ($23.50)



PokerStars Game #59891477054:  Hold'em No Limit ($3/$6 USD) - 2011/03/27 12:45:26 ET
Table 'Griseldis XI' 2-max Seat #2 is the button
Seat 1: fightingnuns ($417 in chips) 
Seat 2: mascom ($230.50 in chips) 
mascom: posts small blind $3
fightingnuns: posts big blind $6
*** HOLE CARDS ***
Dealt to fightingnuns [8s Ac]
mascom: raises $6 to $12
fightingnuns: calls $6
*** FLOP *** [3s 4c Js]
fightingnuns: checks 
mascom: bets $12
fightingnuns: calls $12
*** TURN *** [3s 4c Js] [8c]
fightingnuns: checks 
mascom: bets $33
fightingnuns: calls $33
*** RIVER *** [3s 4c Js 8c] [Jh]
fightingnuns: checks 
mascom: checks 
*** SHOW DOWN ***
fightingnuns: shows [8s Ac] (two pair, Jacks and Eights)
mascom: mucks hand 
fightingnuns collected $113.50 from pot
*** SUMMARY ***
Total pot $114 | Rake $0.50 
Board [3s 4c Js 8c Jh]
Seat 1: fightingnuns (big blind) showed [8s Ac] and won ($113.50) with two pair, Jacks and Eights
Seat 2: mascom (button) (small blind) mucked [3d As]



PokerStars Game #59891516482:  Hold'em No Limit ($3/$6 USD) - 2011/03/27 12:46:08 ET
Table 'Griseldis XI' 2-max Seat #1 is the button
Seat 1: fightingnuns ($473.50 in chips) 
Seat 2: mascom ($173.50 in chips) 
fightingnuns: posts small blind $3
mascom: posts big blind $6
*** HOLE CARDS ***
Dealt to fightingnuns [6d Th]
fightingnuns: folds 
Uncalled bet ($3) returned to mascom
mascom collected $6 from pot
*** SUMMARY ***
Total pot $6 | Rake $0 
Seat 1: fightingnuns (button) (small blind) folded before Flop
Seat 2: mascom (big blind) collected ($6)



PokerStars Game #59891523342:  Hold'em No Limit ($3/$6 USD) - 2011/03/27 12:46:15 ET
Table 'Griseldis XI' 2-max Seat #2 is the button
Seat 1: fightingnuns ($470.50 in chips) 
Seat 2: mascom ($176.50 in chips) 
mascom: posts small blind $3
fightingnuns: posts big blind $6
*** HOLE CARDS ***
Dealt to fightingnuns [4h Td]
mascom: raises $6 to $12
fightingnuns: folds 
Uncalled bet ($6) returned to mascom
mascom collected $12 from pot
*** SUMMARY ***
Total pot $12 | Rake $0 
Seat 1: fightingnuns (big blind) folded before Flop
Seat 2: mascom (button) (small blind) collected ($12)



PokerStars Game #59891531885:  Hold'em No Limit ($3/$6 USD) - 2011/03/27 12:46:24 ET
Table 'Griseldis XI' 2-max Seat #1 is the button
Seat 1: fightingnuns ($464.50 in chips) 
Seat 2: mascom ($182.50 in chips) 
fightingnuns: posts small blind $3
mascom: posts big blind $6
*** HOLE CARDS ***
Dealt to fightingnuns [3h Ts]
fightingnuns: folds 
Uncalled bet ($3) returned to mascom
mascom collected $6 from pot
*** SUMMARY ***
Total pot $6 | Rake $0 
Seat 1: fightingnuns (button) (small blind) folded before Flop
Seat 2: mascom (big blind) collected ($6)



PokerStars Game #59891537306:  Hold'em No Limit ($3/$6 USD) - 2011/03/27 12:46:30 ET
Table 'Griseldis XI' 2-max Seat #2 is the button
Seat 1: fightingnuns ($461.50 in chips) 
Seat 2: mascom ($185.50 in chips) 
mascom: posts small blind $3
fightingnuns: posts big blind $6
*** HOLE CARDS ***
Dealt to fightingnuns [Th Td]
mascom: raises $6 to $12
mascom said, "youre a suckout machine"
fightingnuns: raises $24 to $36
mascom: calls $24
*** FLOP *** [Tc Ks 9c]
fightingnuns: bets $36
mascom: raises $113.50 to $149.50 and is all-in
fightingnuns: calls $113.50
*** TURN *** [Tc Ks 9c] [5s]
*** RIVER *** [Tc Ks 9c 5s] [As]
*** SHOW DOWN ***
fightingnuns: shows [Th Td] (three of a kind, Tens)
mascom: shows [Kd Js] (a pair of Kings)
fightingnuns collected $370.50 from pot
*** SUMMARY ***
Total pot $371 | Rake $0.50 
Board [Tc Ks 9c 5s As]
Seat 1: fightingnuns (big blind) showed [Th Td] and won ($370.50) with three of a kind, Tens
Seat 2: mascom (button) (small blind) showed [Kd Js] and lost with a pair of Kings



PokerStars Game #59891605525:  Hold'em No Limit ($3/$6 USD) - 2011/03/27 12:47:41 ET
Table 'Griseldis XI' 2-max Seat #1 is the button
Seat 1: fightingnuns ($646.50 in chips) 
Seat 2: mascom ($300 in chips) 
fightingnuns: posts small blind $3
mascom: posts big blind $6
*** HOLE CARDS ***
Dealt to fightingnuns [Qd 2c]
fightingnuns: folds 
Uncalled bet ($3) returned to mascom
mascom collected $6 from pot
*** SUMMARY ***
Total pot $6 | Rake $0 
Seat 1: fightingnuns (button) (small blind) folded before Flop
Seat 2: mascom (big blind) collected ($6)



PokerStars Game #59891612107:  Hold'em No Limit ($3/$6 USD) - 2011/03/27 12:47:48 ET
Table 'Griseldis XI' 2-max Seat #2 is the button
Seat 1: fightingnuns ($643.50 in chips) 
Seat 2: mascom ($303 in chips) 
mascom: posts small blind $3
fightingnuns: posts big blind $6
*** HOLE CARDS ***
Dealt to fightingnuns [8c 4d]
mascom: raises $6 to $12
fightingnuns: folds 
Uncalled bet ($6) returned to mascom
mascom collected $12 from pot
*** SUMMARY ***
Total pot $12 | Rake $0 
Seat 1: fightingnuns (big blind) folded before Flop
Seat 2: mascom (button) (small blind) collected ($12)



PokerStars Game #59891620569:  Hold'em No Limit ($3/$6 USD) - 2011/03/27 12:47:57 ET
Table 'Griseldis XI' 2-max Seat #1 is the button
Seat 1: fightingnuns ($637.50 in chips) 
Seat 2: mascom ($309 in chips) 
fightingnuns: posts small blind $3
mascom: posts big blind $6
*** HOLE CARDS ***
Dealt to fightingnuns [Qc 7d]
fightingnuns: raises $6 to $12
mascom: calls $6
*** FLOP *** [Kd Jd 6d]
mascom: bets $20
fightingnuns: folds 
Uncalled bet ($20) returned to mascom
mascom collected $23.50 from pot
*** SUMMARY ***
Total pot $24 | Rake $0.50 
Board [Kd Jd 6d]
Seat 1: fightingnuns (button) (small blind) folded on the Flop
Seat 2: mascom (big blind) collected ($23.50)



PokerStars Game #59891638357:  Hold'em No Limit ($3/$6 USD) - 2011/03/27 12:48:16 ET
Table 'Griseldis XI' 2-max Seat #2 is the button
Seat 1: fightingnuns ($625.50 in chips) 
Seat 2: mascom ($320.50 in chips) 
mascom: posts small blind $3
fightingnuns: posts big blind $6
*** HOLE CARDS ***
Dealt to fightingnuns [6d Ac]
mascom: raises $6 to $12
fightingnuns: calls $6
*** FLOP *** [3s Tc Js]
fightingnuns: checks 
mascom: bets $20
fightingnuns: folds 
Uncalled bet ($20) returned to mascom
mascom collected $23.50 from pot
*** SUMMARY ***
Total pot $24 | Rake $0.50 
Board [3s Tc Js]
Seat 1: fightingnuns (big blind) folded on the Flop
Seat 2: mascom (button) (small blind) collected ($23.50)



PokerStars Game #59891659715:  Hold'em No Limit ($3/$6 USD) - 2011/03/27 12:48:38 ET
Table 'Griseldis XI' 2-max Seat #1 is the button
Seat 1: fightingnuns ($613.50 in chips) 
Seat 2: mascom ($332 in chips) 
fightingnuns: posts small blind $3
mascom: posts big blind $6
*** HOLE CARDS ***
Dealt to fightingnuns [8c Qs]
fightingnuns: raises $6 to $12
mascom: calls $6
*** FLOP *** [7c 8d 3h]
mascom: checks 
fightingnuns: bets $18
mascom: folds 
Uncalled bet ($18) returned to fightingnuns
fightingnuns collected $23.50 from pot
fightingnuns: doesn't show hand 
*** SUMMARY ***
Total pot $24 | Rake $0.50 
Board [7c 8d 3h]
Seat 1: fightingnuns (button) (small blind) collected ($23.50)
Seat 2: mascom (big blind) folded on the Flop



PokerStars Game #59891684940:  Hold'em No Limit ($3/$6 USD) - 2011/03/27 12:49:05 ET
Table 'Griseldis XI' 2-max Seat #2 is the button
Seat 1: fightingnuns ($625 in chips) 
Seat 2: mascom ($320 in chips) 
mascom: posts small blind $3
fightingnuns: posts big blind $6
*** HOLE CARDS ***
Dealt to fightingnuns [3h 7h]
mascom: raises $6 to $12
fightingnuns: folds 
Uncalled bet ($6) returned to mascom
mascom collected $12 from pot
*** SUMMARY ***
Total pot $12 | Rake $0 
Seat 1: fightingnuns (big blind) folded before Flop
Seat 2: mascom (button) (small blind) collected ($12)



PokerStars Game #59891695461:  Hold'em No Limit ($3/$6 USD) - 2011/03/27 12:49:16 ET
Table 'Griseldis XI' 2-max Seat #1 is the button
Seat 1: fightingnuns ($619 in chips) 
Seat 2: mascom ($326 in chips) 
fightingnuns: posts small blind $3
mascom: posts big blind $6
*** HOLE CARDS ***
Dealt to fightingnuns [2d 8h]
fightingnuns: folds 
Uncalled bet ($3) returned to mascom
mascom collected $6 from pot
*** SUMMARY ***
Total pot $6 | Rake $0 
Seat 1: fightingnuns (button) (small blind) folded before Flop
Seat 2: mascom (big blind) collected ($6)



PokerStars Game #59891701726:  Hold'em No Limit ($3/$6 USD) - 2011/03/27 12:49:23 ET
Table 'Griseldis XI' 2-max Seat #2 is the button
Seat 1: fightingnuns ($616 in chips) 
Seat 2: mascom ($329 in chips) 
mascom: posts small blind $3
fightingnuns: posts big blind $6
*** HOLE CARDS ***
Dealt to fightingnuns [7c Th]
mascom: raises $6 to $12
fightingnuns: folds 
Uncalled bet ($6) returned to mascom
mascom collected $12 from pot
*** SUMMARY ***
Total pot $12 | Rake $0 
Seat 1: fightingnuns (big blind) folded before Flop
Seat 2: mascom (button) (small blind) collected ($12)



PokerStars Game #59891711102:  Hold'em No Limit ($3/$6 USD) - 2011/03/27 12:49:33 ET
Table 'Griseldis XI' 2-max Seat #1 is the button
Seat 1: fightingnuns ($610 in chips) 
Seat 2: mascom ($335 in chips) 
fightingnuns: posts small blind $3
mascom: posts big blind $6
*** HOLE CARDS ***
Dealt to fightingnuns [Td 6d]
fightingnuns: raises $6 to $12
mascom: raises $24 to $36
fightingnuns: folds 
Uncalled bet ($24) returned to mascom
mascom collected $24 from pot
*** SUMMARY ***
Total pot $24 | Rake $0 
Seat 1: fightingnuns (button) (small blind) folded before Flop
Seat 2: mascom (big blind) collected ($24)



PokerStars Game #59891724299:  Hold'em No Limit ($3/$6 USD) - 2011/03/27 12:49:47 ET
Table 'Griseldis XI' 2-max Seat #2 is the button
Seat 1: fightingnuns ($598 in chips) 
Seat 2: mascom ($347 in chips) 
mascom: posts small blind $3
fightingnuns: posts big blind $6
*** HOLE CARDS ***
Dealt to fightingnuns [Tc 7c]
mascom: raises $6 to $12
fightingnuns: calls $6
*** FLOP *** [5c Kh 2d]
fightingnuns: checks 
mascom: bets $20
fightingnuns: folds 
Uncalled bet ($20) returned to mascom
mascom collected $23.50 from pot
*** SUMMARY ***
Total pot $24 | Rake $0.50 
Board [5c Kh 2d]
Seat 1: fightingnuns (big blind) folded on the Flop
Seat 2: mascom (button) (small blind) collected ($23.50)



PokerStars Game #59891742841:  Hold'em No Limit ($3/$6 USD) - 2011/03/27 12:50:07 ET
Table 'Griseldis XI' 2-max Seat #1 is the button
Seat 1: fightingnuns ($586 in chips) 
Seat 2: mascom ($358.50 in chips) 
fightingnuns: posts small blind $3
mascom: posts big blind $6
*** HOLE CARDS ***
Dealt to fightingnuns [Ah 4s]
fightingnuns: raises $6 to $12
mascom: raises $24 to $36
fightingnuns: folds 
Uncalled bet ($24) returned to mascom
mascom collected $24 from pot
*** SUMMARY ***
Total pot $24 | Rake $0 
Seat 1: fightingnuns (button) (small blind) folded before Flop
Seat 2: mascom (big blind) collected ($24)



PokerStars Game #59891756304:  Hold'em No Limit ($3/$6 USD) - 2011/03/27 12:50:21 ET
Table 'Griseldis XI' 2-max Seat #2 is the button
Seat 1: fightingnuns ($574 in chips) 
Seat 2: mascom ($370.50 in chips) 
mascom: posts small blind $3
fightingnuns: posts big blind $6
*** HOLE CARDS ***
Dealt to fightingnuns [Qc 3c]
mascom: raises $6 to $12
fightingnuns: calls $6
*** FLOP *** [6s Kh 5h]
fightingnuns: checks 
mascom: bets $20
fightingnuns: folds 
Uncalled bet ($20) returned to mascom
mascom collected $23.50 from pot
*** SUMMARY ***
Total pot $24 | Rake $0.50 
Board [6s Kh 5h]
Seat 1: fightingnuns (big blind) folded on the Flop
Seat 2: mascom (button) (small blind) collected ($23.50)



PokerStars Game #59891772727:  Hold'em No Limit ($3/$6 USD) - 2011/03/27 12:50:38 ET
Table 'Griseldis XI' 2-max Seat #1 is the button
Seat 1: fightingnuns ($562 in chips) 
Seat 2: mascom ($382 in chips) 
fightingnuns: posts small blind $3
mascom: posts big blind $6
*** HOLE CARDS ***
Dealt to fightingnuns [6s 8s]
fightingnuns: raises $6 to $12
mascom: raises $24 to $36
fightingnuns: folds 
Uncalled bet ($24) returned to mascom
mascom collected $24 from pot
*** SUMMARY ***
Total pot $24 | Rake $0 
Seat 1: fightingnuns (button) (small blind) folded before Flop
Seat 2: mascom (big blind) collected ($24)



PokerStars Game #59891788840:  Hold'em No Limit ($3/$6 USD) - 2011/03/27 12:50:55 ET
Table 'Griseldis XI' 2-max Seat #2 is the button
Seat 1: fightingnuns ($550 in chips) 
Seat 2: mascom ($394 in chips) 
mascom: posts small blind $3
fightingnuns: posts big blind $6
*** HOLE CARDS ***
Dealt to fightingnuns [Qd 9d]
mascom: raises $6 to $12
fightingnuns: raises $24 to $36
mascom: calls $24
*** FLOP *** [6h 5d 3d]
fightingnuns: checks 
mascom: bets $55
fightingnuns: raises $459 to $514 and is all-in
mascom: folds 
Uncalled bet ($459) returned to fightingnuns
fightingnuns collected $181.50 from pot
fightingnuns: doesn't show hand 
*** SUMMARY ***
Total pot $182 | Rake $0.50 
Board [6h 5d 3d]
Seat 1: fightingnuns (big blind) collected ($181.50)
Seat 2: mascom (button) (small blind) folded on the Flop



PokerStars Game #59891835002:  Hold'em No Limit ($3/$6 USD) - 2011/03/27 12:51:44 ET
Table 'Griseldis XI' 2-max Seat #1 is the button
Seat 1: fightingnuns ($640.50 in chips) 
Seat 2: mascom ($303 in chips) 
fightingnuns: posts small blind $3
mascom: posts big blind $6
*** HOLE CARDS ***
Dealt to fightingnuns [9d 4d]
fightingnuns: folds 
Uncalled bet ($3) returned to mascom
mascom collected $6 from pot
*** SUMMARY ***
Total pot $6 | Rake $0 
Seat 1: fightingnuns (button) (small blind) folded before Flop
Seat 2: mascom (big blind) collected ($6)



PokerStars Game #59891841681:  Hold'em No Limit ($3/$6 USD) - 2011/03/27 12:51:51 ET
Table 'Griseldis XI' 2-max Seat #2 is the button
Seat 1: fightingnuns ($637.50 in chips) 
Seat 2: mascom ($306 in chips) 
mascom: posts small blind $3
fightingnuns: posts big blind $6
*** HOLE CARDS ***
Dealt to fightingnuns [5d 9d]
mascom: raises $6 to $12
fightingnuns: calls $6
*** FLOP *** [Qc Ad Jh]
fightingnuns: checks 
mascom: bets $12
fightingnuns: folds 
Uncalled bet ($12) returned to mascom
mascom collected $23.50 from pot
*** SUMMARY ***
Total pot $24 | Rake $0.50 
Board [Qc Ad Jh]
Seat 1: fightingnuns (big blind) folded on the Flop
Seat 2: mascom (button) (small blind) collected ($23.50)



PokerStars Game #59891857232:  Hold'em No Limit ($3/$6 USD) - 2011/03/27 12:52:08 ET
Table 'Griseldis XI' 2-max Seat #1 is the button
Seat 1: fightingnuns ($625.50 in chips) 
Seat 2: mascom ($317.50 in chips) 
fightingnuns: posts small blind $3
mascom: posts big blind $6
*** HOLE CARDS ***
Dealt to fightingnuns [9h Qh]
fightingnuns: raises $6 to $12
mascom: calls $6
*** FLOP *** [9c 7d Td]
mascom: checks 
fightingnuns: checks 
*** TURN *** [9c 7d Td] [Kd]
mascom: checks 
fightingnuns: checks 
*** RIVER *** [9c 7d Td Kd] [2c]
mascom: bets $22
fightingnuns: calls $22
*** SHOW DOWN ***
mascom: shows [3h 4d] (high card King)
fightingnuns: shows [9h Qh] (a pair of Nines)
fightingnuns collected $67.50 from pot
*** SUMMARY ***
Total pot $68 | Rake $0.50 
Board [9c 7d Td Kd 2c]
Seat 1: fightingnuns (button) (small blind) showed [9h Qh] and won ($67.50) with a pair of Nines
Seat 2: mascom (big blind) showed [3h 4d] and lost with high card King



PokerStars Game #59891889719:  Hold'em No Limit ($3/$6 USD) - 2011/03/27 12:52:42 ET
Table 'Griseldis XI' 2-max Seat #2 is the button
Seat 1: fightingnuns ($659 in chips) 
Seat 2: mascom ($283.50 in chips) 
mascom: posts small blind $3
fightingnuns: posts big blind $6
*** HOLE CARDS ***
Dealt to fightingnuns [Qd Qc]
mascom: raises $6 to $12
fightingnuns: raises $24 to $36
mascom: calls $24
*** FLOP *** [Jd 6c Ah]
fightingnuns: checks 
mascom: checks 
*** TURN *** [Jd 6c Ah] [9h]
fightingnuns: bets $36
mascom: calls $36
*** RIVER *** [Jd 6c Ah 9h] [Js]
fightingnuns: checks 
mascom: bets $125
fightingnuns: calls $125
*** SHOW DOWN ***
mascom: shows [Jc 8d] (three of a kind, Jacks)
fightingnuns: mucks hand 
mascom collected $393.50 from pot
*** SUMMARY ***
Total pot $394 | Rake $0.50 
Board [Jd 6c Ah 9h Js]
Seat 1: fightingnuns (big blind) mucked [Qd Qc]
Seat 2: mascom (button) (small blind) showed [Jc 8d] and won ($393.50) with three of a kind, Jacks



PokerStars Game #59891927655:  Hold'em No Limit ($3/$6 USD) - 2011/03/27 12:53:22 ET
Table 'Griseldis XI' 2-max Seat #1 is the button
Seat 1: fightingnuns ($462 in chips) 
Seat 2: mascom ($480 in chips) 
fightingnuns: posts small blind $3
mascom: posts big blind $6
*** HOLE CARDS ***
Dealt to fightingnuns [Jd 3c]
fightingnuns: folds 
Uncalled bet ($3) returned to mascom
mascom collected $6 from pot
*** SUMMARY ***
Total pot $6 | Rake $0 
Seat 1: fightingnuns (button) (small blind) folded before Flop
Seat 2: mascom (big blind) collected ($6)



PokerStars Game #59891932961:  Hold'em No Limit ($3/$6 USD) - 2011/03/27 12:53:28 ET
Table 'Griseldis XI' 2-max Seat #2 is the button
Seat 1: fightingnuns ($459 in chips) 
Seat 2: mascom ($483 in chips) 
mascom: posts small blind $3
fightingnuns: posts big blind $6
*** HOLE CARDS ***
Dealt to fightingnuns [Kh 8h]
mascom: raises $6 to $12
fightingnuns: calls $6
*** FLOP *** [3c 9c Qd]
fightingnuns: checks 
mascom: checks 
*** TURN *** [3c 9c Qd] [8s]
fightingnuns: checks 
mascom: checks 
*** RIVER *** [3c 9c Qd 8s] [6d]
fightingnuns: bets $12
mascom: folds 
Uncalled bet ($12) returned to fightingnuns
fightingnuns collected $23.50 from pot
fightingnuns: doesn't show hand 
*** SUMMARY ***
Total pot $24 | Rake $0.50 
Board [3c 9c Qd 8s 6d]
Seat 1: fightingnuns (big blind) collected ($23.50)
Seat 2: mascom (button) (small blind) folded on the River



PokerStars Game #59891956098:  Hold'em No Limit ($3/$6 USD) - 2011/03/27 12:53:53 ET
Table 'Griseldis XI' 2-max Seat #1 is the button
Seat 1: fightingnuns ($470.50 in chips) 
Seat 2: mascom ($471 in chips) 
fightingnuns: posts small blind $3
mascom: posts big blind $6
*** HOLE CARDS ***
Dealt to fightingnuns [Ac Ts]
fightingnuns: raises $6 to $12
mascom: calls $6
*** FLOP *** [2s 2h 9s]
mascom: bets $20
fightingnuns: calls $20
*** TURN *** [2s 2h 9s] [Kd]
mascom: checks 
fightingnuns: bets $48
mascom: calls $48
*** RIVER *** [2s 2h 9s Kd] [3s]
mascom: checks 
fightingnuns: checks 
*** SHOW DOWN ***
mascom: shows [5c Ah] (a pair of Deuces)
fightingnuns: shows [Ac Ts] (a pair of Deuces - Ace+King+Ten kicker)
fightingnuns collected $159.50 from pot
*** SUMMARY ***
Total pot $160 | Rake $0.50 
Board [2s 2h 9s Kd 3s]
Seat 1: fightingnuns (button) (small blind) showed [Ac Ts] and won ($159.50) with a pair of Deuces
Seat 2: mascom (big blind) showed [5c Ah] and lost with a pair of Deuces



PokerStars Game #59892002441:  Hold'em No Limit ($3/$6 USD) - 2011/03/27 12:54:42 ET
Table 'Griseldis XI' 2-max Seat #2 is the button
Seat 1: fightingnuns ($550 in chips) 
Seat 2: mascom ($391 in chips) 
mascom: posts small blind $3
fightingnuns: posts big blind $6
*** HOLE CARDS ***
Dealt to fightingnuns [7s Qc]
mascom: raises $6 to $12
fightingnuns: folds 
Uncalled bet ($6) returned to mascom
mascom collected $12 from pot
*** SUMMARY ***
Total pot $12 | Rake $0 
Seat 1: fightingnuns (big blind) folded before Flop
Seat 2: mascom (button) (small blind) collected ($12)



PokerStars Game #59892012138:  Hold'em No Limit ($3/$6 USD) - 2011/03/27 12:54:52 ET
Table 'Griseldis XI' 2-max Seat #1 is the button
Seat 1: fightingnuns ($544 in chips) 
Seat 2: mascom ($397 in chips) 
fightingnuns: posts small blind $3
mascom: posts big blind $6
*** HOLE CARDS ***
Dealt to fightingnuns [5s 2c]
fightingnuns: folds 
Uncalled bet ($3) returned to mascom
mascom collected $6 from pot
*** SUMMARY ***
Total pot $6 | Rake $0 
Seat 1: fightingnuns (button) (small blind) folded before Flop
Seat 2: mascom (big blind) collected ($6)



PokerStars Game #59892017889:  Hold'em No Limit ($3/$6 USD) - 2011/03/27 12:54:59 ET
Table 'Griseldis XI' 2-max Seat #2 is the button
Seat 1: fightingnuns ($541 in chips) 
Seat 2: mascom ($400 in chips) 
mascom: posts small blind $3
fightingnuns: posts big blind $6
*** HOLE CARDS ***
Dealt to fightingnuns [8d Qs]
mascom: raises $6 to $12
fightingnuns: calls $6
*** FLOP *** [6s Qd 6c]
fightingnuns: checks 
mascom: bets $12
fightingnuns: raises $24 to $36
mascom: raises $41 to $77
fightingnuns: calls $41
*** TURN *** [6s Qd 6c] [6d]
fightingnuns: checks 
mascom: bets $100
fightingnuns: calls $100
*** RIVER *** [6s Qd 6c 6d] [Ts]
fightingnuns: checks 
mascom: checks 
*** SHOW DOWN ***
fightingnuns: shows [8d Qs] (a full house, Sixes full of Queens)
mascom: mucks hand 
fightingnuns collected $377.50 from pot
*** SUMMARY ***
Total pot $378 | Rake $0.50 
Board [6s Qd 6c 6d Ts]
Seat 1: fightingnuns (big blind) showed [8d Qs] and won ($377.50) with a full house, Sixes full of Queens
Seat 2: mascom (button) (small blind) mucked [Th 3h]



PokerStars Game #59892060765:  Hold'em No Limit ($3/$6 USD) - 2011/03/27 12:55:58 ET
Table 'Griseldis XI' 2-max Seat #1 is the button
Seat 1: fightingnuns ($729.50 in chips) 
Seat 2: mascom ($211 in chips) 
fightingnuns: posts small blind $3
mascom: posts big blind $6
*** HOLE CARDS ***
Dealt to fightingnuns [Th 4h]
fightingnuns: raises $6 to $12
mascom: folds 
Uncalled bet ($6) returned to fightingnuns
fightingnuns collected $12 from pot
fightingnuns: doesn't show hand 
*** SUMMARY ***
Total pot $12 | Rake $0 
Seat 1: fightingnuns (button) (small blind) collected ($12)
Seat 2: mascom (big blind) folded before Flop



PokerStars Game #59892067417:  Hold'em No Limit ($3/$6 USD) - 2011/03/27 12:56:07 ET
Table 'Griseldis XI' 2-max Seat #2 is the button
Seat 1: fightingnuns ($735.50 in chips) 
Seat 2: mascom ($205 in chips) 
mascom: posts small blind $3
fightingnuns: posts big blind $6
*** HOLE CARDS ***
Dealt to fightingnuns [Tc 9h]
mascom: raises $6 to $12
fightingnuns: calls $6
*** FLOP *** [6d 9d Ad]
fightingnuns: checks 
mascom: bets $12
fightingnuns: calls $12
*** TURN *** [6d 9d Ad] [6h]
fightingnuns: checks 
mascom: bets $44
fightingnuns: folds 
Uncalled bet ($44) returned to mascom
mascom collected $47.50 from pot
*** SUMMARY ***
Total pot $48 | Rake $0.50 
Board [6d 9d Ad 6h]
Seat 1: fightingnuns (big blind) folded on the Turn
Seat 2: mascom (button) (small blind) collected ($47.50)



PokerStars Game #59892089811:  Hold'em No Limit ($3/$6 USD) - 2011/03/27 12:56:38 ET
Table 'Griseldis XI' 2-max Seat #1 is the button
Seat 1: fightingnuns ($711.50 in chips) 
Seat 2: mascom ($300 in chips) 
fightingnuns: posts small blind $3
mascom: posts big blind $6
*** HOLE CARDS ***
Dealt to fightingnuns [5h 7c]
fightingnuns: folds 
Uncalled bet ($3) returned to mascom
mascom collected $6 from pot
*** SUMMARY ***
Total pot $6 | Rake $0 
Seat 1: fightingnuns (button) (small blind) folded before Flop
Seat 2: mascom (big blind) collected ($6)



PokerStars Game #59892094294:  Hold'em No Limit ($3/$6 USD) - 2011/03/27 12:56:45 ET
Table 'Griseldis XI' 2-max Seat #2 is the button
Seat 1: fightingnuns ($708.50 in chips) 
Seat 2: mascom ($303 in chips) 
mascom: posts small blind $3
fightingnuns: posts big blind $6
*** HOLE CARDS ***
Dealt to fightingnuns [9h 5d]
mascom: raises $6 to $12
fightingnuns: folds 
Uncalled bet ($6) returned to mascom
mascom collected $12 from pot
*** SUMMARY ***
Total pot $12 | Rake $0 
Seat 1: fightingnuns (big blind) folded before Flop
Seat 2: mascom (button) (small blind) collected ($12)



PokerStars Game #59892101825:  Hold'em No Limit ($3/$6 USD) - 2011/03/27 12:56:55 ET
Table 'Griseldis XI' 2-max Seat #1 is the button
Seat 1: fightingnuns ($702.50 in chips) 
Seat 2: mascom ($309 in chips) 
fightingnuns: posts small blind $3
mascom: posts big blind $6
*** HOLE CARDS ***
Dealt to fightingnuns [Kh 4c]
fightingnuns: raises $6 to $12
mascom: raises $24 to $36
fightingnuns: folds 
Uncalled bet ($24) returned to mascom
mascom collected $24 from pot
*** SUMMARY ***
Total pot $24 | Rake $0 
Seat 1: fightingnuns (button) (small blind) folded before Flop
Seat 2: mascom (big blind) collected ($24)



PokerStars Game #59892114813:  Hold'em No Limit ($3/$6 USD) - 2011/03/27 12:57:14 ET
Table 'Griseldis XI' 2-max Seat #2 is the button
Seat 1: fightingnuns ($690.50 in chips) 
Seat 2: mascom ($321 in chips) 
mascom: posts small blind $3
fightingnuns: posts big blind $6
*** HOLE CARDS ***
Dealt to fightingnuns [Tc 9c]
mascom: raises $6 to $12
fightingnuns: calls $6
*** FLOP *** [8h Qc Jd]
fightingnuns: checks 
mascom: bets $12
fightingnuns: raises $24 to $36
mascom: folds 
Uncalled bet ($24) returned to fightingnuns
fightingnuns collected $47.50 from pot
fightingnuns: doesn't show hand 
*** SUMMARY ***
Total pot $48 | Rake $0.50 
Board [8h Qc Jd]
Seat 1: fightingnuns (big blind) collected ($47.50)
Seat 2: mascom (button) (small blind) folded on the Flop



PokerStars Game #59892132439:  Hold'em No Limit ($3/$6 USD) - 2011/03/27 12:57:38 ET
Table 'Griseldis XI' 2-max Seat #1 is the button
Seat 1: fightingnuns ($714 in chips) 
Seat 2: mascom ($297 in chips) 
fightingnuns: posts small blind $3
mascom: posts big blind $6
*** HOLE CARDS ***
Dealt to fightingnuns [As 5d]
fightingnuns: raises $6 to $12
mascom: folds 
Uncalled bet ($6) returned to fightingnuns
fightingnuns collected $12 from pot
fightingnuns: doesn't show hand 
*** SUMMARY ***
Total pot $12 | Rake $0 
Seat 1: fightingnuns (button) (small blind) collected ($12)
Seat 2: mascom (big blind) folded before Flop



PokerStars Game #59892137707:  Hold'em No Limit ($3/$6 USD) - 2011/03/27 12:57:45 ET
Table 'Griseldis XI' 2-max Seat #2 is the button
Seat 1: fightingnuns ($720 in chips) 
Seat 2: mascom ($291 in chips) 
mascom: posts small blind $3
fightingnuns: posts big blind $6
*** HOLE CARDS ***
Dealt to fightingnuns [3s As]
mascom: raises $6 to $12
fightingnuns: calls $6
*** FLOP *** [7h Ah 4h]
fightingnuns: checks 
mascom: bets $12
fightingnuns: calls $12
*** TURN *** [7h Ah 4h] [Qd]
fightingnuns: checks 
mascom: bets $44
fightingnuns: calls $44
*** RIVER *** [7h Ah 4h Qd] [8d]
fightingnuns: checks 
mascom: bets $100
fightingnuns: calls $100
*** SHOW DOWN ***
mascom: shows [4d 7d] (two pair, Sevens and Fours)
fightingnuns: mucks hand 
mascom collected $335.50 from pot
*** SUMMARY ***
Total pot $336 | Rake $0.50 
Board [7h Ah 4h Qd 8d]
Seat 1: fightingnuns (big blind) mucked [3s As]
Seat 2: mascom (button) (small blind) showed [4d 7d] and won ($335.50) with two pair, Sevens and Fours



PokerStars Game #59892167980:  Hold'em No Limit ($3/$6 USD) - 2011/03/27 12:58:28 ET
Table 'Griseldis XI' 2-max Seat #1 is the button
Seat 1: fightingnuns ($552 in chips) 
Seat 2: mascom ($458.50 in chips) 
fightingnuns: posts small blind $3
mascom: posts big blind $6
*** HOLE CARDS ***
Dealt to fightingnuns [9d Tc]
fightingnuns: raises $6 to $12
mascom: folds 
Uncalled bet ($6) returned to fightingnuns
fightingnuns collected $12 from pot
fightingnuns: doesn't show hand 
*** SUMMARY ***
Total pot $12 | Rake $0 
Seat 1: fightingnuns (button) (small blind) collected ($12)
Seat 2: mascom (big blind) folded before Flop



PokerStars Game #59892176390:  Hold'em No Limit ($3/$6 USD) - 2011/03/27 12:58:39 ET
Table 'Griseldis XI' 2-max Seat #2 is the button
Seat 1: fightingnuns ($558 in chips) 
Seat 2: mascom ($452.50 in chips) 
mascom: posts small blind $3
fightingnuns: posts big blind $6
*** HOLE CARDS ***
Dealt to fightingnuns [Kd 6d]
mascom: raises $6 to $12
fightingnuns: calls $6
*** FLOP *** [9c 6h 3c]
fightingnuns: checks 
mascom: bets $12
fightingnuns: calls $12
*** TURN *** [9c 6h 3c] [Th]
fightingnuns: checks 
mascom: bets $44
fightingnuns: folds 
Uncalled bet ($44) returned to mascom
mascom collected $47.50 from pot
*** SUMMARY ***
Total pot $48 | Rake $0.50 
Board [9c 6h 3c Th]
Seat 1: fightingnuns (big blind) folded on the Turn
Seat 2: mascom (button) (small blind) collected ($47.50)



PokerStars Game #59892197380:  Hold'em No Limit ($3/$6 USD) - 2011/03/27 12:59:09 ET
Table 'Griseldis XI' 2-max Seat #1 is the button
Seat 1: fightingnuns ($534 in chips) 
Seat 2: mascom ($476 in chips) 
fightingnuns: posts small blind $3
mascom: posts big blind $6
*** HOLE CARDS ***
Dealt to fightingnuns [7c 2s]
fightingnuns: folds 
Uncalled bet ($3) returned to mascom
mascom collected $6 from pot
*** SUMMARY ***
Total pot $6 | Rake $0 
Seat 1: fightingnuns (button) (small blind) folded before Flop
Seat 2: mascom (big blind) collected ($6)



PokerStars Game #59892201754:  Hold'em No Limit ($3/$6 USD) - 2011/03/27 12:59:14 ET
Table 'Griseldis XI' 2-max Seat #2 is the button
Seat 1: fightingnuns ($531 in chips) 
Seat 2: mascom ($479 in chips) 
mascom: posts small blind $3
fightingnuns: posts big blind $6
*** HOLE CARDS ***
Dealt to fightingnuns [2d Td]
mascom: folds 
Uncalled bet ($3) returned to fightingnuns
fightingnuns collected $6 from pot
fightingnuns: doesn't show hand 
*** SUMMARY ***
Total pot $6 | Rake $0 
Seat 1: fightingnuns (big blind) collected ($6)
Seat 2: mascom (button) (small blind) folded before Flop



PokerStars Game #59892207875:  Hold'em No Limit ($3/$6 USD) - 2011/03/27 12:59:23 ET
Table 'Griseldis XI' 2-max Seat #1 is the button
Seat 1: fightingnuns ($534 in chips) 
Seat 2: mascom ($476 in chips) 
fightingnuns: posts small blind $3
mascom: posts big blind $6
*** HOLE CARDS ***
Dealt to fightingnuns [9s Qc]
fightingnuns: raises $6 to $12
mascom: raises $24 to $36
fightingnuns: folds 
Uncalled bet ($24) returned to mascom
mascom collected $24 from pot
*** SUMMARY ***
Total pot $24 | Rake $0 
Seat 1: fightingnuns (button) (small blind) folded before Flop
Seat 2: mascom (big blind) collected ($24)



PokerStars Game #59892216780:  Hold'em No Limit ($3/$6 USD) - 2011/03/27 12:59:35 ET
Table 'Griseldis XI' 2-max Seat #2 is the button
Seat 1: fightingnuns ($522 in chips) 
Seat 2: mascom ($488 in chips) 
mascom: posts small blind $3
fightingnuns: posts big blind $6
*** HOLE CARDS ***
Dealt to fightingnuns [5d 3d]
mascom: raises $6 to $12
fightingnuns: folds 
Uncalled bet ($6) returned to mascom
mascom collected $12 from pot
*** SUMMARY ***
Total pot $12 | Rake $0 
Seat 1: fightingnuns (big blind) folded before Flop
Seat 2: mascom (button) (small blind) collected ($12)



PokerStars Game #59892223817:  Hold'em No Limit ($3/$6 USD) - 2011/03/27 12:59:45 ET
Table 'Griseldis XI' 2-max Seat #1 is the button
Seat 1: fightingnuns ($516 in chips) 
Seat 2: mascom ($494 in chips) 
fightingnuns: posts small blind $3
mascom: posts big blind $6
*** HOLE CARDS ***
Dealt to fightingnuns [Qs Jd]
fightingnuns: raises $6 to $12
mascom: raises $24 to $36
fightingnuns: calls $24
*** FLOP *** [2s Ts 6h]
mascom: checks 
fightingnuns: checks 
*** TURN *** [2s Ts 6h] [Qh]
mascom: bets $44
fightingnuns: calls $44
*** RIVER *** [2s Ts 6h Qh] [8h]
mascom: bets $125
fightingnuns: folds 
Uncalled bet ($125) returned to mascom
mascom collected $159.50 from pot
*** SUMMARY ***
Total pot $160 | Rake $0.50 
Board [2s Ts 6h Qh 8h]
Seat 1: fightingnuns (button) (small blind) folded on the River
Seat 2: mascom (big blind) collected ($159.50)



PokerStars Game #59892267767:  Hold'em No Limit ($3/$6 USD) - 2011/03/27 13:00:38 ET
Table 'Griseldis XI' 2-max Seat #2 is the button
Seat 1: fightingnuns ($436 in chips) 
Seat 2: mascom ($573.50 in chips) 
mascom: posts small blind $3
fightingnuns: posts big blind $6
*** HOLE CARDS ***
Dealt to fightingnuns [8h 3d]
mascom: raises $6 to $12
fightingnuns: folds 
Uncalled bet ($6) returned to mascom
mascom collected $12 from pot
*** SUMMARY ***
Total pot $12 | Rake $0 
Seat 1: fightingnuns (big blind) folded before Flop
Seat 2: mascom (button) (small blind) collected ($12)



PokerStars Game #59892275538:  Hold'em No Limit ($3/$6 USD) - 2011/03/27 13:00:47 ET
Table 'Griseldis XI' 2-max Seat #1 is the button
Seat 1: fightingnuns ($430 in chips) 
Seat 2: mascom ($579.50 in chips) 
fightingnuns: posts small blind $3
mascom: posts big blind $6
*** HOLE CARDS ***
Dealt to fightingnuns [4s 3d]
fightingnuns: folds 
Uncalled bet ($3) returned to mascom
mascom collected $6 from pot
*** SUMMARY ***
Total pot $6 | Rake $0 
Seat 1: fightingnuns (button) (small blind) folded before Flop
Seat 2: mascom (big blind) collected ($6)



PokerStars Game #59892280274:  Hold'em No Limit ($3/$6 USD) - 2011/03/27 13:00:53 ET
Table 'Griseldis XI' 2-max Seat #2 is the button
Seat 1: fightingnuns ($427 in chips) 
Seat 2: mascom ($582.50 in chips) 
mascom: posts small blind $3
fightingnuns: posts big blind $6
*** HOLE CARDS ***
Dealt to fightingnuns [2d 3d]
mascom: raises $6 to $12
fightingnuns: folds 
Uncalled bet ($6) returned to mascom
mascom collected $12 from pot
*** SUMMARY ***
Total pot $12 | Rake $0 
Seat 1: fightingnuns (big blind) folded before Flop
Seat 2: mascom (button) (small blind) collected ($12)



PokerStars Game #59892287150:  Hold'em No Limit ($3/$6 USD) - 2011/03/27 13:01:00 ET
Table 'Griseldis XI' 2-max Seat #1 is the button
Seat 1: fightingnuns ($421 in chips) 
Seat 2: mascom ($588.50 in chips) 
fightingnuns: posts small blind $3
mascom: posts big blind $6
*** HOLE CARDS ***
Dealt to fightingnuns [Th Qs]
fightingnuns: raises $6 to $12
mascom: raises $24 to $36
fightingnuns: calls $24
*** FLOP *** [Ac 5d 8h]
mascom: bets $33
fightingnuns: folds 
Uncalled bet ($33) returned to mascom
mascom collected $71.50 from pot
*** SUMMARY ***
Total pot $72 | Rake $0.50 
Board [Ac 5d 8h]
Seat 1: fightingnuns (button) (small blind) folded on the Flop
Seat 2: mascom (big blind) collected ($71.50)



PokerStars Game #59892306539:  Hold'em No Limit ($3/$6 USD) - 2011/03/27 13:01:22 ET
Table 'Griseldis XI' 2-max Seat #2 is the button
Seat 1: fightingnuns ($385 in chips) 
Seat 2: mascom ($624 in chips) 
mascom: posts small blind $3
fightingnuns: posts big blind $6
*** HOLE CARDS ***
Dealt to fightingnuns [Kh 6s]
mascom: folds 
Uncalled bet ($3) returned to fightingnuns
fightingnuns collected $6 from pot
fightingnuns: doesn't show hand 
*** SUMMARY ***
Total pot $6 | Rake $0 
Seat 1: fightingnuns (big blind) collected ($6)
Seat 2: mascom (button) (small blind) folded before Flop



PokerStars Game #59892314392:  Hold'em No Limit ($3/$6 USD) - 2011/03/27 13:01:30 ET
Table 'Griseldis XI' 2-max Seat #1 is the button
Seat 1: fightingnuns ($388 in chips) 
Seat 2: mascom ($621 in chips) 
fightingnuns: posts small blind $3
mascom: posts big blind $6
*** HOLE CARDS ***
Dealt to fightingnuns [3c 9h]
fightingnuns: folds 
Uncalled bet ($3) returned to mascom
mascom collected $6 from pot
*** SUMMARY ***
Total pot $6 | Rake $0 
Seat 1: fightingnuns (button) (small blind) folded before Flop
Seat 2: mascom (big blind) collected ($6)



PokerStars Game #59892319662:  Hold'em No Limit ($3/$6 USD) - 2011/03/27 13:01:36 ET
Table 'Griseldis XI' 2-max Seat #2 is the button
Seat 1: fightingnuns ($385 in chips) 
Seat 2: mascom ($624 in chips) 
mascom: posts small blind $3
fightingnuns: posts big blind $6
*** HOLE CARDS ***
Dealt to fightingnuns [Qh 2s]
mascom: raises $6 to $12
fightingnuns: folds 
Uncalled bet ($6) returned to mascom
mascom collected $12 from pot
*** SUMMARY ***
Total pot $12 | Rake $0 
Seat 1: fightingnuns (big blind) folded before Flop
Seat 2: mascom (button) (small blind) collected ($12)



PokerStars Game #59892328021:  Hold'em No Limit ($3/$6 USD) - 2011/03/27 13:01:45 ET
Table 'Griseldis XI' 2-max Seat #1 is the button
Seat 1: fightingnuns ($379 in chips) 
Seat 2: mascom ($630 in chips) 
fightingnuns: posts small blind $3
mascom: posts big blind $6
*** HOLE CARDS ***
Dealt to fightingnuns [7s Th]
fightingnuns: folds 
Uncalled bet ($3) returned to mascom
mascom collected $6 from pot
*** SUMMARY ***
Total pot $6 | Rake $0 
Seat 1: fightingnuns (button) (small blind) folded before Flop
Seat 2: mascom (big blind) collected ($6)



PokerStars Game #59892333690:  Hold'em No Limit ($3/$6 USD) - 2011/03/27 13:01:51 ET
Table 'Griseldis XI' 2-max Seat #2 is the button
Seat 1: fightingnuns ($376 in chips) 
Seat 2: mascom ($633 in chips) 
mascom: posts small blind $3
fightingnuns: posts big blind $6
*** HOLE CARDS ***
Dealt to fightingnuns [8d 9c]
mascom: raises $6 to $12
fightingnuns: folds 
Uncalled bet ($6) returned to mascom
mascom collected $12 from pot
*** SUMMARY ***
Total pot $12 | Rake $0 
Seat 1: fightingnuns (big blind) folded before Flop
Seat 2: mascom (button) (small blind) collected ($12)



PokerStars Game #59892342695:  Hold'em No Limit ($3/$6 USD) - 2011/03/27 13:02:00 ET
Table 'Griseldis XI' 2-max Seat #1 is the button
Seat 1: fightingnuns ($370 in chips) 
Seat 2: mascom ($639 in chips) 
fightingnuns: posts small blind $3
mascom: posts big blind $6
*** HOLE CARDS ***
Dealt to fightingnuns [8h Tc]
fightingnuns: raises $6 to $12
mascom: folds 
Uncalled bet ($6) returned to fightingnuns
fightingnuns collected $12 from pot
fightingnuns: doesn't show hand 
*** SUMMARY ***
Total pot $12 | Rake $0 
Seat 1: fightingnuns (button) (small blind) collected ($12)
Seat 2: mascom (big blind) folded before Flop



PokerStars Game #59892353105:  Hold'em No Limit ($3/$6 USD) - 2011/03/27 13:02:10 ET
Table 'Griseldis XI' 2-max Seat #2 is the button
Seat 1: fightingnuns ($376 in chips) 
Seat 2: mascom ($633 in chips) 
mascom: posts small blind $3
fightingnuns: posts big blind $6
*** HOLE CARDS ***
Dealt to fightingnuns [Kd 5c]
mascom: raises $6 to $12
fightingnuns: folds 
Uncalled bet ($6) returned to mascom
mascom collected $12 from pot
*** SUMMARY ***
Total pot $12 | Rake $0 
Seat 1: fightingnuns (big blind) folded before Flop
Seat 2: mascom (button) (small blind) collected ($12)



PokerStars Game #59892362091:  Hold'em No Limit ($3/$6 USD) - 2011/03/27 13:02:20 ET
Table 'Griseldis XI' 2-max Seat #1 is the button
Seat 1: fightingnuns ($370 in chips) 
Seat 2: mascom ($639 in chips) 
fightingnuns: posts small blind $3
mascom: posts big blind $6
*** HOLE CARDS ***
Dealt to fightingnuns [8c Kh]
fightingnuns: raises $6 to $12
mascom: calls $6
*** FLOP *** [2d Ks 4d]
mascom: checks 
fightingnuns: bets $18
mascom: folds 
Uncalled bet ($18) returned to fightingnuns
fightingnuns collected $23.50 from pot
fightingnuns: doesn't show hand 
*** SUMMARY ***
Total pot $24 | Rake $0.50 
Board [2d Ks 4d]
Seat 1: fightingnuns (button) (small blind) collected ($23.50)
Seat 2: mascom (big blind) folded on the Flop



PokerStars Game #59892380298:  Hold'em No Limit ($3/$6 USD) - 2011/03/27 13:02:39 ET
Table 'Griseldis XI' 2-max Seat #2 is the button
Seat 1: fightingnuns ($381.50 in chips) 
Seat 2: mascom ($627 in chips) 
mascom: posts small blind $3
fightingnuns: posts big blind $6
*** HOLE CARDS ***
Dealt to fightingnuns [4s 2c]
mascom: raises $6 to $12
fightingnuns: folds 
Uncalled bet ($6) returned to mascom
mascom collected $12 from pot
*** SUMMARY ***
Total pot $12 | Rake $0 
Seat 1: fightingnuns (big blind) folded before Flop
Seat 2: mascom (button) (small blind) collected ($12)



PokerStars Game #59892391137:  Hold'em No Limit ($3/$6 USD) - 2011/03/27 13:02:49 ET
Table 'Griseldis XI' 2-max Seat #1 is the button
Seat 1: fightingnuns ($375.50 in chips) 
Seat 2: mascom ($633 in chips) 
fightingnuns: posts small blind $3
mascom: posts big blind $6
*** HOLE CARDS ***
Dealt to fightingnuns [4s Jd]
fightingnuns: folds 
Uncalled bet ($3) returned to mascom
mascom collected $6 from pot
*** SUMMARY ***
Total pot $6 | Rake $0 
Seat 1: fightingnuns (button) (small blind) folded before Flop
Seat 2: mascom (big blind) collected ($6)



PokerStars Game #59892397011:  Hold'em No Limit ($3/$6 USD) - 2011/03/27 13:02:55 ET
Table 'Griseldis XI' 2-max Seat #2 is the button
Seat 1: fightingnuns ($372.50 in chips) 
Seat 2: mascom ($636 in chips) 
mascom: posts small blind $3
fightingnuns: posts big blind $6
*** HOLE CARDS ***
Dealt to fightingnuns [Td Qs]
mascom: raises $6 to $12
fightingnuns: raises $24 to $36
mascom: folds 
Uncalled bet ($24) returned to fightingnuns
fightingnuns collected $24 from pot
fightingnuns: doesn't show hand 
*** SUMMARY ***
Total pot $24 | Rake $0 
Seat 1: fightingnuns (big blind) collected ($24)
Seat 2: mascom (button) (small blind) folded before Flop



PokerStars Game #59892413405:  Hold'em No Limit ($3/$6 USD) - 2011/03/27 13:03:11 ET
Table 'Griseldis XI' 2-max Seat #1 is the button
Seat 1: fightingnuns ($384.50 in chips) 
Seat 2: mascom ($624 in chips) 
fightingnuns: posts small blind $3
mascom: posts big blind $6
*** HOLE CARDS ***
Dealt to fightingnuns [9s As]
fightingnuns: raises $6 to $12
mascom: folds 
Uncalled bet ($6) returned to fightingnuns
fightingnuns collected $12 from pot
fightingnuns: doesn't show hand 
*** SUMMARY ***
Total pot $12 | Rake $0 
Seat 1: fightingnuns (button) (small blind) collected ($12)
Seat 2: mascom (big blind) folded before Flop



PokerStars Game #59892424140:  Hold'em No Limit ($3/$6 USD) - 2011/03/27 13:03:22 ET
Table 'Griseldis XI' 2-max Seat #2 is the button
Seat 1: fightingnuns ($390.50 in chips) 
Seat 2: mascom ($618 in chips) 
mascom: posts small blind $3
fightingnuns: posts big blind $6
*** HOLE CARDS ***
Dealt to fightingnuns [Td Jd]
mascom: raises $6 to $12
fightingnuns: calls $6
*** FLOP *** [7c 3s Th]
fightingnuns: checks 
mascom: bets $12
fightingnuns: calls $12
*** TURN *** [7c 3s Th] [6h]
fightingnuns: checks 
mascom: bets $44
fightingnuns: calls $44
*** RIVER *** [7c 3s Th 6h] [2d]
fightingnuns: checks 
mascom: checks 
*** SHOW DOWN ***
fightingnuns: shows [Td Jd] (a pair of Tens)
mascom: mucks hand 
fightingnuns collected $135.50 from pot
*** SUMMARY ***
Total pot $136 | Rake $0.50 
Board [7c 3s Th 6h 2d]
Seat 1: fightingnuns (big blind) showed [Td Jd] and won ($135.50) with a pair of Tens
Seat 2: mascom (button) (small blind) mucked [8h Ah]



PokerStars Game #59892462080:  Hold'em No Limit ($3/$6 USD) - 2011/03/27 13:03:58 ET
Table 'Griseldis XI' 2-max Seat #1 is the button
Seat 1: fightingnuns ($458 in chips) 
Seat 2: mascom ($550 in chips) 
fightingnuns: posts small blind $3
mascom: posts big blind $6
*** HOLE CARDS ***
Dealt to fightingnuns [6h 8c]
fightingnuns: raises $6 to $12
mascom: raises $24 to $36
fightingnuns: folds 
Uncalled bet ($24) returned to mascom
mascom collected $24 from pot
*** SUMMARY ***
Total pot $24 | Rake $0 
Seat 1: fightingnuns (button) (small blind) folded before Flop
Seat 2: mascom (big blind) collected ($24)



PokerStars Game #59892477141:  Hold'em No Limit ($3/$6 USD) - 2011/03/27 13:04:13 ET
Table 'Griseldis XI' 2-max Seat #2 is the button
Seat 1: fightingnuns ($446 in chips) 
Seat 2: mascom ($562 in chips) 
mascom: posts small blind $3
fightingnuns: posts big blind $6
*** HOLE CARDS ***
Dealt to fightingnuns [Jh 6s]
mascom: raises $6 to $12
fightingnuns: folds 
Uncalled bet ($6) returned to mascom
mascom collected $12 from pot
*** SUMMARY ***
Total pot $12 | Rake $0 
Seat 1: fightingnuns (big blind) folded before Flop
Seat 2: mascom (button) (small blind) collected ($12)



PokerStars Game #59892486223:  Hold'em No Limit ($3/$6 USD) - 2011/03/27 13:04:22 ET
Table 'Griseldis XI' 2-max Seat #1 is the button
Seat 1: fightingnuns ($440 in chips) 
Seat 2: mascom ($568 in chips) 
fightingnuns: posts small blind $3
mascom: posts big blind $6
*** HOLE CARDS ***
Dealt to fightingnuns [Kc 6s]
fightingnuns: raises $6 to $12
mascom: folds 
Uncalled bet ($6) returned to fightingnuns
fightingnuns collected $12 from pot
fightingnuns: doesn't show hand 
*** SUMMARY ***
Total pot $12 | Rake $0 
Seat 1: fightingnuns (button) (small blind) collected ($12)
Seat 2: mascom (big blind) folded before Flop



PokerStars Game #59892500339:  Hold'em No Limit ($3/$6 USD) - 2011/03/27 13:04:35 ET
Table 'Griseldis XI' 2-max Seat #2 is the button
Seat 1: fightingnuns ($446 in chips) 
Seat 2: mascom ($562 in chips) 
mascom: posts small blind $3
fightingnuns: posts big blind $6
*** HOLE CARDS ***
Dealt to fightingnuns [Jd 8c]
mascom: raises $6 to $12
fightingnuns: calls $6
*** FLOP *** [6d Kd 9c]
fightingnuns: checks 
mascom: bets $12
fightingnuns: folds 
Uncalled bet ($12) returned to mascom
mascom collected $23.50 from pot
*** SUMMARY ***
Total pot $24 | Rake $0.50 
Board [6d Kd 9c]
Seat 1: fightingnuns (big blind) folded on the Flop
Seat 2: mascom (button) (small blind) collected ($23.50)



PokerStars Game #59892523384:  Hold'em No Limit ($3/$6 USD) - 2011/03/27 13:04:57 ET
Table 'Griseldis XI' 2-max Seat #1 is the button
Seat 1: fightingnuns ($434 in chips) 
Seat 2: mascom ($573.50 in chips) 
fightingnuns: posts small blind $3
mascom: posts big blind $6
*** HOLE CARDS ***
Dealt to fightingnuns [5c Ks]
fightingnuns: folds 
Uncalled bet ($3) returned to mascom
mascom collected $6 from pot
*** SUMMARY ***
Total pot $6 | Rake $0 
Seat 1: fightingnuns (button) (small blind) folded before Flop
Seat 2: mascom (big blind) collected ($6)



PokerStars Game #59892529858:  Hold'em No Limit ($3/$6 USD) - 2011/03/27 13:05:04 ET
Table 'Griseldis XI' 2-max Seat #2 is the button
Seat 1: fightingnuns ($431 in chips) 
Seat 2: mascom ($576.50 in chips) 
mascom: posts small blind $3
fightingnuns: posts big blind $6
*** HOLE CARDS ***
Dealt to fightingnuns [6c 8h]
mascom: raises $6 to $12
fightingnuns: folds 
Uncalled bet ($6) returned to mascom
mascom collected $12 from pot
*** SUMMARY ***
Total pot $12 | Rake $0 
Seat 1: fightingnuns (big blind) folded before Flop
Seat 2: mascom (button) (small blind) collected ($12)



PokerStars Game #59892538810:  Hold'em No Limit ($3/$6 USD) - 2011/03/27 13:05:12 ET
Table 'Griseldis XI' 2-max Seat #1 is the button
Seat 1: fightingnuns ($425 in chips) 
Seat 2: mascom ($582.50 in chips) 
fightingnuns: posts small blind $3
mascom: posts big blind $6
*** HOLE CARDS ***
Dealt to fightingnuns [2d Ks]
fightingnuns: raises $6 to $12
mascom: raises $24 to $36
fightingnuns: folds 
Uncalled bet ($24) returned to mascom
mascom collected $24 from pot
*** SUMMARY ***
Total pot $24 | Rake $0 
Seat 1: fightingnuns (button) (small blind) folded before Flop
Seat 2: mascom (big blind) collected ($24)



PokerStars Game #59892553184:  Hold'em No Limit ($3/$6 USD) - 2011/03/27 13:05:26 ET
Table 'Griseldis XI' 2-max Seat #2 is the button
Seat 1: fightingnuns ($413 in chips) 
Seat 2: mascom ($594.50 in chips) 
mascom: posts small blind $3
fightingnuns: posts big blind $6
*** HOLE CARDS ***
Dealt to fightingnuns [Qh 7s]
mascom: raises $6 to $12
fightingnuns: folds 
Uncalled bet ($6) returned to mascom
mascom collected $12 from pot
*** SUMMARY ***
Total pot $12 | Rake $0 
Seat 1: fightingnuns (big blind) folded before Flop
Seat 2: mascom (button) (small blind) collected ($12)



PokerStars Game #59892567035:  Hold'em No Limit ($3/$6 USD) - 2011/03/27 13:05:39 ET
Table 'Griseldis XI' 2-max Seat #1 is the button
Seat 1: fightingnuns ($407 in chips) 
Seat 2: mascom ($600.50 in chips) 
fightingnuns: posts small blind $3
mascom: posts big blind $6
*** HOLE CARDS ***
Dealt to fightingnuns [8s 9s]
fightingnuns: raises $6 to $12
mascom: folds 
Uncalled bet ($6) returned to fightingnuns
fightingnuns collected $12 from pot
fightingnuns: doesn't show hand 
*** SUMMARY ***
Total pot $12 | Rake $0 
Seat 1: fightingnuns (button) (small blind) collected ($12)
Seat 2: mascom (big blind) folded before Flop



PokerStars Game #59892582396:  Hold'em No Limit ($3/$6 USD) - 2011/03/27 13:05:54 ET
Table 'Griseldis XI' 2-max Seat #2 is the button
Seat 1: fightingnuns ($413 in chips) 
Seat 2: mascom ($594.50 in chips) 
mascom: posts small blind $3
fightingnuns: posts big blind $6
*** HOLE CARDS ***
Dealt to fightingnuns [Jd 6c]
mascom: raises $6 to $12
fightingnuns: folds 
Uncalled bet ($6) returned to mascom
mascom collected $12 from pot
*** SUMMARY ***
Total pot $12 | Rake $0 
Seat 1: fightingnuns (big blind) folded before Flop
Seat 2: mascom (button) (small blind) collected ($12)



PokerStars Game #59892595077:  Hold'em No Limit ($3/$6 USD) - 2011/03/27 13:06:06 ET
Table 'Griseldis XI' 2-max Seat #1 is the button
Seat 1: fightingnuns ($407 in chips) 
Seat 2: mascom ($600.50 in chips) 
fightingnuns: posts small blind $3
mascom: posts big blind $6
*** HOLE CARDS ***
Dealt to fightingnuns [3d Kh]
fightingnuns: raises $6 to $12
mascom: raises $24 to $36
fightingnuns: folds 
Uncalled bet ($24) returned to mascom
mascom collected $24 from pot
*** SUMMARY ***
Total pot $24 | Rake $0 
Seat 1: fightingnuns (button) (small blind) folded before Flop
Seat 2: mascom (big blind) collected ($24)



PokerStars Game #59892608494:  Hold'em No Limit ($3/$6 USD) - 2011/03/27 13:06:19 ET
Table 'Griseldis XI' 2-max Seat #2 is the button
Seat 1: fightingnuns ($395 in chips) 
Seat 2: mascom ($612.50 in chips) 
mascom: posts small blind $3
fightingnuns: posts big blind $6
*** HOLE CARDS ***
Dealt to fightingnuns [5d 8h]
mascom: raises $6 to $12
fightingnuns: folds 
Uncalled bet ($6) returned to mascom
mascom collected $12 from pot
*** SUMMARY ***
Total pot $12 | Rake $0 
Seat 1: fightingnuns (big blind) folded before Flop
Seat 2: mascom (button) (small blind) collected ($12)



PokerStars Game #59892617600:  Hold'em No Limit ($3/$6 USD) - 2011/03/27 13:06:27 ET
Table 'Griseldis XI' 2-max Seat #1 is the button
Seat 1: fightingnuns ($389 in chips) 
Seat 2: mascom ($618.50 in chips) 
fightingnuns: posts small blind $3
mascom: posts big blind $6
*** HOLE CARDS ***
Dealt to fightingnuns [8h Kd]
fightingnuns: raises $6 to $12
mascom: folds 
Uncalled bet ($6) returned to fightingnuns
fightingnuns collected $12 from pot
fightingnuns: doesn't show hand 
*** SUMMARY ***
Total pot $12 | Rake $0 
Seat 1: fightingnuns (button) (small blind) collected ($12)
Seat 2: mascom (big blind) folded before Flop



PokerStars Game #59892626109:  Hold'em No Limit ($3/$6 USD) - 2011/03/27 13:06:35 ET
Table 'Griseldis XI' 2-max Seat #2 is the button
Seat 1: fightingnuns ($395 in chips) 
Seat 2: mascom ($612.50 in chips) 
mascom: posts small blind $3
fightingnuns: posts big blind $6
*** HOLE CARDS ***
Dealt to fightingnuns [7c Kh]
mascom: raises $6 to $12
fightingnuns: folds 
Uncalled bet ($6) returned to mascom
mascom collected $12 from pot
*** SUMMARY ***
Total pot $12 | Rake $0 
Seat 1: fightingnuns (big blind) folded before Flop
Seat 2: mascom (button) (small blind) collected ($12)



PokerStars Game #59892634767:  Hold'em No Limit ($3/$6 USD) - 2011/03/27 13:06:44 ET
Table 'Griseldis XI' 2-max Seat #1 is the button
Seat 1: fightingnuns ($389 in chips) 
Seat 2: mascom ($618.50 in chips) 
fightingnuns: posts small blind $3
mascom: posts big blind $6
*** HOLE CARDS ***
Dealt to fightingnuns [2c Jh]
fightingnuns: folds 
Uncalled bet ($3) returned to mascom
mascom collected $6 from pot
*** SUMMARY ***
Total pot $6 | Rake $0 
Seat 1: fightingnuns (button) (small blind) folded before Flop
Seat 2: mascom (big blind) collected ($6)



PokerStars Game #59892641557:  Hold'em No Limit ($3/$6 USD) - 2011/03/27 13:06:50 ET
Table 'Griseldis XI' 2-max Seat #2 is the button
Seat 1: fightingnuns ($386 in chips) 
Seat 2: mascom ($621.50 in chips) 
mascom: posts small blind $3
fightingnuns: posts big blind $6
*** HOLE CARDS ***
Dealt to fightingnuns [9d 7d]
mascom: raises $6 to $12
fightingnuns: calls $6
*** FLOP *** [Kd Th Ah]
fightingnuns: checks 
mascom: bets $12
fightingnuns: folds 
Uncalled bet ($12) returned to mascom
mascom collected $23.50 from pot
*** SUMMARY ***
Total pot $24 | Rake $0.50 
Board [Kd Th Ah]
Seat 1: fightingnuns (big blind) folded on the Flop
Seat 2: mascom (button) (small blind) collected ($23.50)



PokerStars Game #59892657947:  Hold'em No Limit ($3/$6 USD) - 2011/03/27 13:07:06 ET
Table 'Griseldis XI' 2-max Seat #1 is the button
Seat 1: fightingnuns ($374 in chips) 
Seat 2: mascom ($633 in chips) 
fightingnuns: posts small blind $3
mascom: posts big blind $6
*** HOLE CARDS ***
Dealt to fightingnuns [6c Qc]
fightingnuns: raises $6 to $12
mascom: raises $24 to $36
fightingnuns: folds 
Uncalled bet ($24) returned to mascom
mascom collected $24 from pot
*** SUMMARY ***
Total pot $24 | Rake $0 
Seat 1: fightingnuns (button) (small blind) folded before Flop
Seat 2: mascom (big blind) collected ($24)



PokerStars Game #59892669389:  Hold'em No Limit ($3/$6 USD) - 2011/03/27 13:07:17 ET
Table 'Griseldis XI' 2-max Seat #2 is the button
Seat 1: fightingnuns ($362 in chips) 
Seat 2: mascom ($645 in chips) 
mascom: posts small blind $3
fightingnuns: posts big blind $6
*** HOLE CARDS ***
Dealt to fightingnuns [Td 3h]
mascom: raises $6 to $12
fightingnuns: folds 
Uncalled bet ($6) returned to mascom
mascom collected $12 from pot
*** SUMMARY ***
Total pot $12 | Rake $0 
Seat 1: fightingnuns (big blind) folded before Flop
Seat 2: mascom (button) (small blind) collected ($12)



PokerStars Game #59892680640:  Hold'em No Limit ($3/$6 USD) - 2011/03/27 13:07:28 ET
Table 'Griseldis XI' 2-max Seat #1 is the button
Seat 1: fightingnuns ($356 in chips) 
Seat 2: mascom ($651 in chips) 
fightingnuns: posts small blind $3
mascom: posts big blind $6
*** HOLE CARDS ***
Dealt to fightingnuns [Qs Jd]
fightingnuns: raises $6 to $12
mascom: folds 
Uncalled bet ($6) returned to fightingnuns
fightingnuns collected $12 from pot
fightingnuns: doesn't show hand 
*** SUMMARY ***
Total pot $12 | Rake $0 
Seat 1: fightingnuns (button) (small blind) collected ($12)
Seat 2: mascom (big blind) folded before Flop



PokerStars Game #59892687861:  Hold'em No Limit ($3/$6 USD) - 2011/03/27 13:07:35 ET
Table 'Griseldis XI' 2-max Seat #2 is the button
Seat 1: fightingnuns ($362 in chips) 
Seat 2: mascom ($645 in chips) 
mascom: posts small blind $3
fightingnuns: posts big blind $6
*** HOLE CARDS ***
Dealt to fightingnuns [6c 2h]
mascom: raises $6 to $12
fightingnuns: folds 
Uncalled bet ($6) returned to mascom
mascom collected $12 from pot
*** SUMMARY ***
Total pot $12 | Rake $0 
Seat 1: fightingnuns (big blind) folded before Flop
Seat 2: mascom (button) (small blind) collected ($12)



PokerStars Game #59892698934:  Hold'em No Limit ($3/$6 USD) - 2011/03/27 13:07:46 ET
Table 'Griseldis XI' 2-max Seat #1 is the button
Seat 1: fightingnuns ($356 in chips) 
Seat 2: mascom ($651 in chips) 
fightingnuns: posts small blind $3
mascom: posts big blind $6
*** HOLE CARDS ***
Dealt to fightingnuns [8d As]
fightingnuns: raises $6 to $12
mascom: folds 
Uncalled bet ($6) returned to fightingnuns
fightingnuns collected $12 from pot
fightingnuns: doesn't show hand 
*** SUMMARY ***
Total pot $12 | Rake $0 
Seat 1: fightingnuns (button) (small blind) collected ($12)
Seat 2: mascom (big blind) folded before Flop



PokerStars Game #59892710921:  Hold'em No Limit ($3/$6 USD) - 2011/03/27 13:07:57 ET
Table 'Griseldis XI' 2-max Seat #2 is the button
Seat 1: fightingnuns ($362 in chips) 
Seat 2: mascom ($645 in chips) 
mascom: posts small blind $3
fightingnuns: posts big blind $6
*** HOLE CARDS ***
Dealt to fightingnuns [7s 8s]
mascom: raises $6 to $12
fightingnuns: calls $6
*** FLOP *** [4h 9c 9h]
fightingnuns: checks 
mascom: bets $12
fightingnuns: folds 
Uncalled bet ($12) returned to mascom
mascom collected $23.50 from pot
*** SUMMARY ***
Total pot $24 | Rake $0.50 
Board [4h 9c 9h]
Seat 1: fightingnuns (big blind) folded on the Flop
Seat 2: mascom (button) (small blind) collected ($23.50)



PokerStars Game #59892728596:  Hold'em No Limit ($3/$6 USD) - 2011/03/27 13:08:14 ET
Table 'Griseldis XI' 2-max Seat #1 is the button
Seat 1: fightingnuns ($350 in chips) 
Seat 2: mascom ($656.50 in chips) 
fightingnuns: posts small blind $3
mascom: posts big blind $6
*** HOLE CARDS ***
Dealt to fightingnuns [2c As]
fightingnuns: raises $6 to $12
mascom: folds 
Uncalled bet ($6) returned to fightingnuns
fightingnuns collected $12 from pot
fightingnuns: doesn't show hand 
*** SUMMARY ***
Total pot $12 | Rake $0 
Seat 1: fightingnuns (button) (small blind) collected ($12)
Seat 2: mascom (big blind) folded before Flop



PokerStars Game #59892735913:  Hold'em No Limit ($3/$6 USD) - 2011/03/27 13:08:21 ET
Table 'Griseldis XI' 2-max Seat #2 is the button
Seat 1: fightingnuns ($356 in chips) 
Seat 2: mascom ($650.50 in chips) 
mascom: posts small blind $3
fightingnuns: posts big blind $6
*** HOLE CARDS ***
Dealt to fightingnuns [8d 5s]
mascom: raises $6 to $12
fightingnuns: folds 
Uncalled bet ($6) returned to mascom
mascom collected $12 from pot
*** SUMMARY ***
Total pot $12 | Rake $0 
Seat 1: fightingnuns (big blind) folded before Flop
Seat 2: mascom (button) (small blind) collected ($12)



PokerStars Game #59892745595:  Hold'em No Limit ($3/$6 USD) - 2011/03/27 13:08:30 ET
Table 'Griseldis XI' 2-max Seat #1 is the button
Seat 1: fightingnuns ($350 in chips) 
Seat 2: mascom ($656.50 in chips) 
fightingnuns: posts small blind $3
mascom: posts big blind $6
*** HOLE CARDS ***
Dealt to fightingnuns [7d Kc]
fightingnuns: raises $6 to $12
mascom: raises $24 to $36
fightingnuns: folds 
Uncalled bet ($24) returned to mascom
mascom collected $24 from pot
*** SUMMARY ***
Total pot $24 | Rake $0 
Seat 1: fightingnuns (button) (small blind) folded before Flop
Seat 2: mascom (big blind) collected ($24)



PokerStars Game #59892768293:  Hold'em No Limit ($3/$6 USD) - 2011/03/27 13:08:52 ET
Table 'Griseldis XI' 2-max Seat #2 is the button
Seat 1: fightingnuns ($338 in chips) 
Seat 2: mascom ($668.50 in chips) 
mascom: posts small blind $3
fightingnuns: posts big blind $6
*** HOLE CARDS ***
Dealt to fightingnuns [Kd Jh]
mascom: folds 
Uncalled bet ($3) returned to fightingnuns
fightingnuns collected $6 from pot
fightingnuns: doesn't show hand 
*** SUMMARY ***
Total pot $6 | Rake $0 
Seat 1: fightingnuns (big blind) collected ($6)
Seat 2: mascom (button) (small blind) folded before Flop



PokerStars Game #59892775122:  Hold'em No Limit ($3/$6 USD) - 2011/03/27 13:08:59 ET
Table 'Griseldis XI' 2-max Seat #1 is the button
Seat 1: fightingnuns ($341 in chips) 
Seat 2: mascom ($665.50 in chips) 
fightingnuns: posts small blind $3
mascom: posts big blind $6
*** HOLE CARDS ***
Dealt to fightingnuns [4d 8h]
fightingnuns: folds 
Uncalled bet ($3) returned to mascom
mascom collected $6 from pot
*** SUMMARY ***
Total pot $6 | Rake $0 
Seat 1: fightingnuns (button) (small blind) folded before Flop
Seat 2: mascom (big blind) collected ($6)



PokerStars Game #59892783180:  Hold'em No Limit ($3/$6 USD) - 2011/03/27 13:09:07 ET
Table 'Griseldis XI' 2-max Seat #2 is the button
Seat 1: fightingnuns ($338 in chips) 
Seat 2: mascom ($668.50 in chips) 
mascom: posts small blind $3
fightingnuns: posts big blind $6
*** HOLE CARDS ***
Dealt to fightingnuns [7s Ts]
mascom: raises $6 to $12
fightingnuns: calls $6
*** FLOP *** [7c Qd 4h]
fightingnuns: checks 
mascom: checks 
*** TURN *** [7c Qd 4h] [2c]
fightingnuns: checks 
mascom: checks 
*** RIVER *** [7c Qd 4h 2c] [9c]
fightingnuns: checks 
mascom: checks 
*** SHOW DOWN ***
fightingnuns: shows [7s Ts] (a pair of Sevens)
mascom: mucks hand 
fightingnuns collected $23.50 from pot
*** SUMMARY ***
Total pot $24 | Rake $0.50 
Board [7c Qd 4h 2c 9c]
Seat 1: fightingnuns (big blind) showed [7s Ts] and won ($23.50) with a pair of Sevens
Seat 2: mascom (button) (small blind) mucked [Th Kd]



PokerStars Game #59892816972:  Hold'em No Limit ($3/$6 USD) - 2011/03/27 13:09:39 ET
Table 'Griseldis XI' 2-max Seat #1 is the button
Seat 1: fightingnuns ($349.50 in chips) 
Seat 2: mascom ($656.50 in chips) 
fightingnuns: posts small blind $3
mascom: posts big blind $6
*** HOLE CARDS ***
Dealt to fightingnuns [Kd Jc]
fightingnuns: raises $6 to $12
mascom: folds 
Uncalled bet ($6) returned to fightingnuns
fightingnuns collected $12 from pot
fightingnuns: doesn't show hand 
*** SUMMARY ***
Total pot $12 | Rake $0 
Seat 1: fightingnuns (button) (small blind) collected ($12)
Seat 2: mascom (big blind) folded before Flop



PokerStars Game #59892825976:  Hold'em No Limit ($3/$6 USD) - 2011/03/27 13:09:48 ET
Table 'Griseldis XI' 2-max Seat #2 is the button
Seat 1: fightingnuns ($355.50 in chips) 
Seat 2: mascom ($650.50 in chips) 
mascom: posts small blind $3
fightingnuns: posts big blind $6
*** HOLE CARDS ***
Dealt to fightingnuns [Qd Td]
mascom: raises $6 to $12
fightingnuns: raises $24 to $36
mascom: folds 
Uncalled bet ($24) returned to fightingnuns
fightingnuns collected $24 from pot
fightingnuns: doesn't show hand 
*** SUMMARY ***
Total pot $24 | Rake $0 
Seat 1: fightingnuns (big blind) collected ($24)
Seat 2: mascom (button) (small blind) folded before Flop



PokerStars Game #59892839239:  Hold'em No Limit ($3/$6 USD) - 2011/03/27 13:10:01 ET
Table 'Griseldis XI' 2-max Seat #1 is the button
Seat 1: fightingnuns ($367.50 in chips) 
Seat 2: mascom ($638.50 in chips) 
fightingnuns: posts small blind $3
mascom: posts big blind $6
*** HOLE CARDS ***
Dealt to fightingnuns [As 6c]
fightingnuns: raises $6 to $12
mascom: raises $24 to $36
fightingnuns: folds 
Uncalled bet ($24) returned to mascom
mascom collected $24 from pot
*** SUMMARY ***
Total pot $24 | Rake $0 
Seat 1: fightingnuns (button) (small blind) folded before Flop
Seat 2: mascom (big blind) collected ($24)



PokerStars Game #59892858380:  Hold'em No Limit ($3/$6 USD) - 2011/03/27 13:10:20 ET
Table 'Griseldis XI' 2-max Seat #2 is the button
Seat 1: fightingnuns ($355.50 in chips) 
Seat 2: mascom ($650.50 in chips) 
mascom: posts small blind $3
fightingnuns: posts big blind $6
*** HOLE CARDS ***
Dealt to fightingnuns [5h Th]
mascom: raises $6 to $12
fightingnuns: folds 
Uncalled bet ($6) returned to mascom
mascom collected $12 from pot
*** SUMMARY ***
Total pot $12 | Rake $0 
Seat 1: fightingnuns (big blind) folded before Flop
Seat 2: mascom (button) (small blind) collected ($12)


PokerStars Game #59953172111:  Hold'em No Limit ($2/$4 USD) - 2011/03/28 13:40:24 ET
Table 'Ganesa V' 2-max Seat #2 is the button
Seat 1: fightingnuns ($200 in chips) 
Seat 2: gdtomson ($160 in chips) 
gdtomson: posts small blind $2
fightingnuns: posts big blind $4
*** HOLE CARDS ***
Dealt to fightingnuns [3c 4s]
gdtomson: raises $4 to $8
fightingnuns: folds 
Uncalled bet ($4) returned to gdtomson
gdtomson collected $8 from pot
*** SUMMARY ***
Total pot $8 | Rake $0 
Seat 1: fightingnuns (big blind) folded before Flop
Seat 2: gdtomson (button) (small blind) collected ($8)



PokerStars Game #59953185615:  Hold'em No Limit ($2/$4 USD) - 2011/03/28 13:40:38 ET
Table 'Ganesa V' 2-max Seat #1 is the button
Seat 1: fightingnuns ($200 in chips) 
Seat 2: gdtomson ($164 in chips) 
fightingnuns: posts small blind $2
gdtomson: posts big blind $4
*** HOLE CARDS ***
Dealt to fightingnuns [7s Kc]
fightingnuns: raises $4 to $8
gdtomson: raises $20 to $28
fightingnuns: folds 
Uncalled bet ($20) returned to gdtomson
gdtomson collected $16 from pot
gdtomson: shows [Jd Js] (a pair of Jacks)
*** SUMMARY ***
Total pot $16 | Rake $0 
Seat 1: fightingnuns (button) (small blind) folded before Flop
Seat 2: gdtomson (big blind) collected ($16)



PokerStars Game #59953201169:  Hold'em No Limit ($2/$4 USD) - 2011/03/28 13:40:53 ET
Table 'Ganesa V' 2-max Seat #2 is the button
Seat 1: fightingnuns ($200 in chips) 
Seat 2: gdtomson ($172 in chips) 
gdtomson: posts small blind $2
fightingnuns: posts big blind $4
*** HOLE CARDS ***
Dealt to fightingnuns [4s Kh]
gdtomson: folds 
Uncalled bet ($2) returned to fightingnuns
fightingnuns collected $4 from pot
fightingnuns: doesn't show hand 
*** SUMMARY ***
Total pot $4 | Rake $0 
Seat 1: fightingnuns (big blind) collected ($4)
Seat 2: gdtomson (button) (small blind) folded before Flop



PokerStars Game #59953207793:  Hold'em No Limit ($2/$4 USD) - 2011/03/28 13:41:00 ET
Table 'Ganesa V' 2-max Seat #1 is the button
Seat 1: fightingnuns ($202 in chips) 
Seat 2: gdtomson ($170 in chips) 
fightingnuns: posts small blind $2
gdtomson: posts big blind $4
*** HOLE CARDS ***
Dealt to fightingnuns [9c 8d]
fightingnuns: raises $4 to $8
gdtomson: calls $4
*** FLOP *** [3h 9s Ac]
gdtomson: checks 
fightingnuns: bets $12
gdtomson: calls $12
*** TURN *** [3h 9s Ac] [Kd]
gdtomson: checks 
fightingnuns: checks 
*** RIVER *** [3h 9s Ac Kd] [Ks]
gdtomson: checks 
fightingnuns: checks 
*** SHOW DOWN ***
gdtomson: shows [9h 8s] (two pair, Kings and Nines)
fightingnuns: shows [9c 8d] (two pair, Kings and Nines)
gdtomson collected $19.75 from pot
fightingnuns collected $19.75 from pot
*** SUMMARY ***
Total pot $40 | Rake $0.50 
Board [3h 9s Ac Kd Ks]
Seat 1: fightingnuns (button) (small blind) showed [9c 8d] and won ($19.75) with two pair, Kings and Nines
Seat 2: gdtomson (big blind) showed [9h 8s] and won ($19.75) with two pair, Kings and Nines



PokerStars Game #59953238549:  Hold'em No Limit ($2/$4 USD) - 2011/03/28 13:41:30 ET
Table 'Ganesa V' 2-max Seat #2 is the button
Seat 1: fightingnuns ($201.75 in chips) 
Seat 2: gdtomson ($169.75 in chips) 
gdtomson: posts small blind $2
fightingnuns: posts big blind $4
*** HOLE CARDS ***
Dealt to fightingnuns [Ac 2d]
gdtomson: raises $4 to $8
fightingnuns: folds 
Uncalled bet ($4) returned to gdtomson
gdtomson collected $8 from pot
gdtomson: doesn't show hand 
*** SUMMARY ***
Total pot $8 | Rake $0 
Seat 1: fightingnuns (big blind) folded before Flop
Seat 2: gdtomson (button) (small blind) collected ($8)



PokerStars Game #59953249027:  Hold'em No Limit ($2/$4 USD) - 2011/03/28 13:41:41 ET
Table 'Ganesa V' 2-max Seat #1 is the button
Seat 1: fightingnuns ($200 in chips) 
Seat 2: gdtomson ($173.75 in chips) 
fightingnuns: posts small blind $2
gdtomson: posts big blind $4
*** HOLE CARDS ***
Dealt to fightingnuns [6s 5d]
fightingnuns: raises $4 to $8
gdtomson: calls $4
*** FLOP *** [3h Jc 4s]
gdtomson: bets $12
fightingnuns: calls $12
*** TURN *** [3h Jc 4s] [9c]
gdtomson: checks 
fightingnuns: bets $28
gdtomson: folds 
Uncalled bet ($28) returned to fightingnuns
fightingnuns collected $39.50 from pot
fightingnuns: doesn't show hand 
*** SUMMARY ***
Total pot $40 | Rake $0.50 
Board [3h Jc 4s 9c]
Seat 1: fightingnuns (button) (small blind) collected ($39.50)
Seat 2: gdtomson (big blind) folded on the Turn



PokerStars Game #59953280163:  Hold'em No Limit ($2/$4 USD) - 2011/03/28 13:42:12 ET
Table 'Ganesa V' 2-max Seat #2 is the button
Seat 1: fightingnuns ($219.50 in chips) 
Seat 2: gdtomson ($153.75 in chips) 
gdtomson: posts small blind $2
fightingnuns: posts big blind $4
*** HOLE CARDS ***
Dealt to fightingnuns [Ts 6d]
gdtomson: folds 
Uncalled bet ($2) returned to fightingnuns
fightingnuns collected $4 from pot
fightingnuns: doesn't show hand 
*** SUMMARY ***
Total pot $4 | Rake $0 
Seat 1: fightingnuns (big blind) collected ($4)
Seat 2: gdtomson (button) (small blind) folded before Flop



PokerStars Game #59953286363:  Hold'em No Limit ($2/$4 USD) - 2011/03/28 13:42:19 ET
Table 'Ganesa V' 2-max Seat #1 is the button
Seat 1: fightingnuns ($221.50 in chips) 
Seat 2: gdtomson ($151.75 in chips) 
fightingnuns: posts small blind $2
gdtomson: posts big blind $4
*** HOLE CARDS ***
Dealt to fightingnuns [7c 4d]
fightingnuns: folds 
Uncalled bet ($2) returned to gdtomson
gdtomson collected $4 from pot
gdtomson: doesn't show hand 
*** SUMMARY ***
Total pot $4 | Rake $0 
Seat 1: fightingnuns (button) (small blind) folded before Flop
Seat 2: gdtomson (big blind) collected ($4)



PokerStars Game #59953292272:  Hold'em No Limit ($2/$4 USD) - 2011/03/28 13:42:24 ET
Table 'Ganesa V' 2-max Seat #2 is the button
Seat 1: fightingnuns ($219.50 in chips) 
Seat 2: gdtomson ($153.75 in chips) 
gdtomson: posts small blind $2
fightingnuns: posts big blind $4
*** HOLE CARDS ***
Dealt to fightingnuns [Qs 5d]
gdtomson: raises $4 to $8
fightingnuns: folds 
Uncalled bet ($4) returned to gdtomson
gdtomson collected $8 from pot
gdtomson: doesn't show hand 
*** SUMMARY ***
Total pot $8 | Rake $0 
Seat 1: fightingnuns (big blind) folded before Flop
Seat 2: gdtomson (button) (small blind) collected ($8)



PokerStars Game #59953300899:  Hold'em No Limit ($2/$4 USD) - 2011/03/28 13:42:33 ET
Table 'Ganesa V' 2-max Seat #1 is the button
Seat 1: fightingnuns ($215.50 in chips) 
Seat 2: gdtomson ($157.75 in chips) 
fightingnuns: posts small blind $2
gdtomson: posts big blind $4
*** HOLE CARDS ***
Dealt to fightingnuns [As Th]
fightingnuns: raises $4 to $8
gdtomson: calls $4
*** FLOP *** [8h 2h 4h]
gdtomson: checks 
fightingnuns: checks 
*** TURN *** [8h 2h 4h] [Ac]
gdtomson: checks 
fightingnuns: bets $12
gdtomson: calls $12
*** RIVER *** [8h 2h 4h Ac] [Kh]
gdtomson: bets $24
fightingnuns: calls $24
*** SHOW DOWN ***
gdtomson: shows [Qs 4c] (a pair of Fours)
fightingnuns: shows [As Th] (a flush, King high)
fightingnuns collected $87.50 from pot
*** SUMMARY ***
Total pot $88 | Rake $0.50 
Board [8h 2h 4h Ac Kh]
Seat 1: fightingnuns (button) (small blind) showed [As Th] and won ($87.50) with a flush, King high
Seat 2: gdtomson (big blind) showed [Qs 4c] and lost with a pair of Fours



PokerStars Game #59953331096:  Hold'em No Limit ($2/$4 USD) - 2011/03/28 13:43:03 ET
Table 'Ganesa V' 2-max Seat #2 is the button
Seat 1: fightingnuns ($259 in chips) 
Seat 2: gdtomson ($113.75 in chips) 
gdtomson: posts small blind $2
fightingnuns: posts big blind $4
*** HOLE CARDS ***
Dealt to fightingnuns [7s 6c]
gdtomson: raises $4 to $8
fightingnuns: folds 
Uncalled bet ($4) returned to gdtomson
gdtomson collected $8 from pot
*** SUMMARY ***
Total pot $8 | Rake $0 
Seat 1: fightingnuns (big blind) folded before Flop
Seat 2: gdtomson (button) (small blind) collected ($8)



PokerStars Game #59953341703:  Hold'em No Limit ($2/$4 USD) - 2011/03/28 13:43:14 ET
Table 'Ganesa V' 2-max Seat #1 is the button
Seat 1: fightingnuns ($255 in chips) 
Seat 2: gdtomson ($117.75 in chips) 
fightingnuns: posts small blind $2
gdtomson: posts big blind $4
*** HOLE CARDS ***
Dealt to fightingnuns [9c As]
fightingnuns: raises $4 to $8
gdtomson: calls $4
*** FLOP *** [7c 2s 5d]
gdtomson: checks 
fightingnuns: checks 
*** TURN *** [7c 2s 5d] [Kd]
gdtomson: checks 
fightingnuns: checks 
*** RIVER *** [7c 2s 5d Kd] [7h]
gdtomson: bets $16
fightingnuns: folds 
Uncalled bet ($16) returned to gdtomson
gdtomson collected $15.50 from pot
gdtomson: doesn't show hand 
*** SUMMARY ***
Total pot $16 | Rake $0.50 
Board [7c 2s 5d Kd 7h]
Seat 1: fightingnuns (button) (small blind) folded on the River
Seat 2: gdtomson (big blind) collected ($15.50)



PokerStars Game #59953372402:  Hold'em No Limit ($2/$4 USD) - 2011/03/28 13:43:45 ET
Table 'Ganesa V' 2-max Seat #2 is the button
Seat 1: fightingnuns ($247 in chips) 
Seat 2: gdtomson ($125.25 in chips) 
gdtomson: posts small blind $2
fightingnuns: posts big blind $4
*** HOLE CARDS ***
Dealt to fightingnuns [7d Jh]
gdtomson: raises $4 to $8
fightingnuns: folds 
Uncalled bet ($4) returned to gdtomson
gdtomson collected $8 from pot
gdtomson: doesn't show hand 
*** SUMMARY ***
Total pot $8 | Rake $0 
Seat 1: fightingnuns (big blind) folded before Flop
Seat 2: gdtomson (button) (small blind) collected ($8)



PokerStars Game #59953384056:  Hold'em No Limit ($2/$4 USD) - 2011/03/28 13:43:56 ET
Table 'Ganesa V' 2-max Seat #1 is the button
Seat 1: fightingnuns ($243 in chips) 
Seat 2: gdtomson ($129.25 in chips) 
fightingnuns: posts small blind $2
gdtomson: posts big blind $4
*** HOLE CARDS ***
Dealt to fightingnuns [3c 6d]
fightingnuns: folds 
Uncalled bet ($2) returned to gdtomson
gdtomson collected $4 from pot
gdtomson: doesn't show hand 
*** SUMMARY ***
Total pot $4 | Rake $0 
Seat 1: fightingnuns (button) (small blind) folded before Flop
Seat 2: gdtomson (big blind) collected ($4)



PokerStars Game #59953389824:  Hold'em No Limit ($2/$4 USD) - 2011/03/28 13:44:02 ET
Table 'Ganesa V' 2-max Seat #2 is the button
Seat 1: fightingnuns ($241 in chips) 
Seat 2: gdtomson ($131.25 in chips) 
gdtomson: posts small blind $2
fightingnuns: posts big blind $4
*** HOLE CARDS ***
Dealt to fightingnuns [As 5s]
gdtomson: raises $8 to $12
fightingnuns: calls $8
*** FLOP *** [3d Qc 8c]
gdtomson said, "brb"
fightingnuns: checks 
gdtomson: checks 
*** TURN *** [3d Qc 8c] [8d]
fightingnuns: checks 
gdtomson: bets $16
fightingnuns: folds 
Uncalled bet ($16) returned to gdtomson
gdtomson collected $23.50 from pot
*** SUMMARY ***
Total pot $24 | Rake $0.50 
Board [3d Qc 8c 8d]
Seat 1: fightingnuns (big blind) folded on the Turn
Seat 2: gdtomson (button) (small blind) collected ($23.50)



PokerStars Game #59953800970:  Hold'em No Limit ($2/$4 USD) - 2011/03/28 13:50:57 ET
Table 'Ganesa V' 2-max Seat #1 is the button
Seat 1: fightingnuns ($229 in chips) 
Seat 2: nullifier1 ($200 in chips) 
fightingnuns: posts small blind $2
nullifier1: posts big blind $4
*** HOLE CARDS ***
Dealt to fightingnuns [Th 8s]
fightingnuns: raises $4 to $8
nullifier1: calls $4
*** FLOP *** [Qd 9d 4s]
nullifier1: checks 
fightingnuns: checks 
*** TURN *** [Qd 9d 4s] [4d]
nullifier1: checks 
fightingnuns: checks 
*** RIVER *** [Qd 9d 4s 4d] [4c]
nullifier1: checks 
fightingnuns: checks 
*** SHOW DOWN ***
nullifier1: shows [Ah 7s] (three of a kind, Fours)
fightingnuns: mucks hand 
nullifier1 collected $15.50 from pot
*** SUMMARY ***
Total pot $16 | Rake $0.50 
Board [Qd 9d 4s 4d 4c]
Seat 1: fightingnuns (button) (small blind) mucked [Th 8s]
Seat 2: nullifier1 (big blind) showed [Ah 7s] and won ($15.50) with three of a kind, Fours



PokerStars Game #59953824366:  Hold'em No Limit ($2/$4 USD) - 2011/03/28 13:51:21 ET
Table 'Ganesa V' 2-max Seat #2 is the button
Seat 1: fightingnuns ($221 in chips) 
Seat 2: nullifier1 ($207.50 in chips) 
nullifier1: posts small blind $2
fightingnuns: posts big blind $4
*** HOLE CARDS ***
Dealt to fightingnuns [8d 7d]
nullifier1: raises $4 to $8
fightingnuns: folds 
Uncalled bet ($4) returned to nullifier1
nullifier1 collected $8 from pot
nullifier1: doesn't show hand 
*** SUMMARY ***
Total pot $8 | Rake $0 
Seat 1: fightingnuns (big blind) folded before Flop
Seat 2: nullifier1 (button) (small blind) collected ($8)



PokerStars Game #59975097561:  Hold'em No Limit ($2/$4 USD) - 2011/03/28 19:43:20 ET
Table 'Ganesa V' 2-max Seat #1 is the button
Seat 1: fightingnuns ($217 in chips) 
Seat 2: lucky443 ($127 in chips) 
fightingnuns: posts small blind $2
lucky443 said, "gl"
lucky443: posts big blind $4
*** HOLE CARDS ***
Dealt to fightingnuns [As Tc]
fightingnuns: raises $4 to $8
lucky443: raises $119 to $127 and is all-in
fightingnuns: calls $119
*** FLOP *** [8d 5d 6d]
*** TURN *** [8d 5d 6d] [Qs]
*** RIVER *** [8d 5d 6d Qs] [Ah]
*** SHOW DOWN ***
lucky443: shows [5c Ks] (a pair of Fives)
fightingnuns: shows [As Tc] (a pair of Aces)
fightingnuns collected $253.50 from pot
*** SUMMARY ***
Total pot $254 | Rake $0.50 
Board [8d 5d 6d Qs Ah]
Seat 1: fightingnuns (button) (small blind) showed [As Tc] and won ($253.50) with a pair of Aces
Seat 2: lucky443 (big blind) showed [5c Ks] and lost with a pair of Fives



PokerStars Game #59908884024:  Hold'em No Limit ($2/$4 USD) - 2011/03/27 16:56:38 ET
Table 'Pulcherrima XI' 2-max Seat #2 is the button
Seat 1: fightingnuns ($400 in chips) 
Seat 2: PThooor ($400 in chips) 
PThooor: posts small blind $2
fightingnuns: posts big blind $4
*** HOLE CARDS ***
Dealt to fightingnuns [2s 4c]
PThooor: raises $8 to $12
fightingnuns: folds 
Uncalled bet ($8) returned to PThooor
PThooor collected $8 from pot
*** SUMMARY ***
Total pot $8 | Rake $0 
Seat 1: fightingnuns (big blind) folded before Flop
Seat 2: PThooor (button) (small blind) collected ($8)



PokerStars Game #59908892264:  Hold'em No Limit ($2/$4 USD) - 2011/03/27 16:56:48 ET
Table 'Pulcherrima XI' 2-max Seat #1 is the button
Seat 1: fightingnuns ($400 in chips) 
Seat 2: PThooor ($404 in chips) 
fightingnuns: posts small blind $2
PThooor: posts big blind $4
*** HOLE CARDS ***
Dealt to fightingnuns [9d 5s]
fightingnuns: raises $8 to $12
PThooor: raises $28 to $40
fightingnuns: folds 
Uncalled bet ($28) returned to PThooor
PThooor collected $24 from pot
*** SUMMARY ***
Total pot $24 | Rake $0 
Seat 1: fightingnuns (button) (small blind) folded before Flop
Seat 2: PThooor (big blind) collected ($24)



PokerStars Game #59908903189:  Hold'em No Limit ($2/$4 USD) - 2011/03/27 16:57:02 ET
Table 'Pulcherrima XI' 2-max Seat #2 is the button
Seat 1: fightingnuns ($400 in chips) 
Seat 2: PThooor ($416 in chips) 
PThooor: posts small blind $2
fightingnuns: posts big blind $4
*** HOLE CARDS ***
Dealt to fightingnuns [9h 2d]
PThooor: raises $8 to $12
fightingnuns: folds 
Uncalled bet ($8) returned to PThooor
PThooor collected $8 from pot
*** SUMMARY ***
Total pot $8 | Rake $0 
Seat 1: fightingnuns (big blind) folded before Flop
Seat 2: PThooor (button) (small blind) collected ($8)



PokerStars Game #59908914367:  Hold'em No Limit ($2/$4 USD) - 2011/03/27 16:57:15 ET
Table 'Pulcherrima XI' 2-max Seat #1 is the button
Seat 1: fightingnuns ($400 in chips) 
Seat 2: PThooor ($420 in chips) 
fightingnuns: posts small blind $2
PThooor: posts big blind $4
*** HOLE CARDS ***
Dealt to fightingnuns [2d As]
fightingnuns: folds 
Uncalled bet ($2) returned to PThooor
PThooor collected $4 from pot
*** SUMMARY ***
Total pot $4 | Rake $0 
Seat 1: fightingnuns (button) (small blind) folded before Flop
Seat 2: PThooor (big blind) collected ($4)



PokerStars Game #59914853576:  Hold'em No Limit ($2/$4 USD) - 2011/03/27 18:28:52 ET
Table 'Pulcherrima XI' 2-max Seat #2 is the button
Seat 1: fightingnuns ($400 in chips) 
Seat 2: otvar132 ($320 in chips) 
otvar132: posts small blind $2
fightingnuns: posts big blind $4
*** HOLE CARDS ***
Dealt to fightingnuns [8c 8d]
otvar132: calls $2
fightingnuns: raises $12 to $16
otvar132: folds 
Uncalled bet ($12) returned to fightingnuns
fightingnuns collected $8 from pot
fightingnuns: doesn't show hand 
*** SUMMARY ***
Total pot $8 | Rake $0 
Seat 1: fightingnuns (big blind) collected ($8)
Seat 2: otvar132 (button) (small blind) folded before Flop



PokerStars Game #59914866289:  Hold'em No Limit ($2/$4 USD) - 2011/03/27 18:29:04 ET
Table 'Pulcherrima XI' 2-max Seat #1 is the button
Seat 1: fightingnuns ($404 in chips) 
Seat 2: otvar132 ($316 in chips) 
fightingnuns: posts small blind $2
otvar132: posts big blind $4
*** HOLE CARDS ***
Dealt to fightingnuns [5h 4c]
fightingnuns: raises $8 to $12
otvar132: calls $8
*** FLOP *** [9d Td 6s]
otvar132: checks 
fightingnuns: bets $16
otvar132: raises $40 to $56
fightingnuns: folds 
Uncalled bet ($40) returned to otvar132
otvar132 collected $55.50 from pot
otvar132: doesn't show hand 
*** SUMMARY ***
Total pot $56 | Rake $0.50 
Board [9d Td 6s]
Seat 1: fightingnuns (button) (small blind) folded on the Flop
Seat 2: otvar132 (big blind) collected ($55.50)



PokerStars Game #59914885112:  Hold'em No Limit ($2/$4 USD) - 2011/03/27 18:29:23 ET
Table 'Pulcherrima XI' 2-max Seat #2 is the button
Seat 1: fightingnuns ($400 in chips) 
Seat 2: otvar132 ($343.50 in chips) 
otvar132: posts small blind $2
fightingnuns: posts big blind $4
*** HOLE CARDS ***
Dealt to fightingnuns [6h 7c]
otvar132: calls $2
fightingnuns: checks 
*** FLOP *** [Kc 2s 6s]
fightingnuns: checks 
otvar132: bets $4
fightingnuns: calls $4
*** TURN *** [Kc 2s 6s] [Jh]
fightingnuns: checks 
otvar132: bets $4
fightingnuns: calls $4
*** RIVER *** [Kc 2s 6s Jh] [7h]
fightingnuns: bets $20
otvar132: folds 
Uncalled bet ($20) returned to fightingnuns
fightingnuns collected $23.50 from pot
fightingnuns: doesn't show hand 
*** SUMMARY ***
Total pot $24 | Rake $0.50 
Board [Kc 2s 6s Jh 7h]
Seat 1: fightingnuns (big blind) collected ($23.50)
Seat 2: otvar132 (button) (small blind) folded on the River



PokerStars Game #59914917324:  Hold'em No Limit ($2/$4 USD) - 2011/03/27 18:29:55 ET
Table 'Pulcherrima XI' 2-max Seat #1 is the button
Seat 1: fightingnuns ($411.50 in chips) 
Seat 2: otvar132 ($331.50 in chips) 
fightingnuns: posts small blind $2
otvar132: posts big blind $4
*** HOLE CARDS ***
Dealt to fightingnuns [7s 5s]
fightingnuns: raises $8 to $12
otvar132: calls $8
*** FLOP *** [6c Qh Td]
otvar132: checks 
fightingnuns: checks 
*** TURN *** [6c Qh Td] [8c]
otvar132: checks 
fightingnuns: bets $16
otvar132: calls $16
*** RIVER *** [6c Qh Td 8c] [Kh]
otvar132: checks 
fightingnuns: checks 
*** SHOW DOWN ***
otvar132: shows [7h 5h] (high card King)
fightingnuns: shows [7s 5s] (high card King)
otvar132 collected $27.75 from pot
fightingnuns collected $27.75 from pot
*** SUMMARY ***
Total pot $56 | Rake $0.50 
Board [6c Qh Td 8c Kh]
Seat 1: fightingnuns (button) (small blind) showed [7s 5s] and won ($27.75) with high card King
Seat 2: otvar132 (big blind) showed [7h 5h] and won ($27.75) with high card King



PokerStars Game #59914944907:  Hold'em No Limit ($2/$4 USD) - 2011/03/27 18:30:23 ET
Table 'Pulcherrima XI' 2-max Seat #2 is the button
Seat 1: fightingnuns ($411.25 in chips) 
Seat 2: otvar132 ($331.25 in chips) 
otvar132: posts small blind $2
fightingnuns: posts big blind $4
*** HOLE CARDS ***
Dealt to fightingnuns [5h Jc]
otvar132: folds 
Uncalled bet ($2) returned to fightingnuns
fightingnuns collected $4 from pot
fightingnuns: doesn't show hand 
*** SUMMARY ***
Total pot $4 | Rake $0 
Seat 1: fightingnuns (big blind) collected ($4)
Seat 2: otvar132 (button) (small blind) folded before Flop



PokerStars Game #59914952673:  Hold'em No Limit ($2/$4 USD) - 2011/03/27 18:30:31 ET
Table 'Pulcherrima XI' 2-max Seat #1 is the button
Seat 1: fightingnuns ($413.25 in chips) 
Seat 2: otvar132 ($329.25 in chips) 
fightingnuns: posts small blind $2
otvar132: posts big blind $4
*** HOLE CARDS ***
Dealt to fightingnuns [8d 9d]
fightingnuns: raises $8 to $12
otvar132: folds 
Uncalled bet ($8) returned to fightingnuns
fightingnuns collected $8 from pot
fightingnuns: doesn't show hand 
*** SUMMARY ***
Total pot $8 | Rake $0 
Seat 1: fightingnuns (button) (small blind) collected ($8)
Seat 2: otvar132 (big blind) folded before Flop



PokerStars Game #59914960229:  Hold'em No Limit ($2/$4 USD) - 2011/03/27 18:30:38 ET
Table 'Pulcherrima XI' 2-max Seat #2 is the button
Seat 1: fightingnuns ($417.25 in chips) 
Seat 2: otvar132 ($325.25 in chips) 
otvar132: posts small blind $2
fightingnuns: posts big blind $4
*** HOLE CARDS ***
Dealt to fightingnuns [9d 5s]
otvar132: folds 
Uncalled bet ($2) returned to fightingnuns
fightingnuns collected $4 from pot
fightingnuns: doesn't show hand 
*** SUMMARY ***
Total pot $4 | Rake $0 
Seat 1: fightingnuns (big blind) collected ($4)
Seat 2: otvar132 (button) (small blind) folded before Flop



PokerStars Game #59914966886:  Hold'em No Limit ($2/$4 USD) - 2011/03/27 18:30:45 ET
Table 'Pulcherrima XI' 2-max Seat #1 is the button
Seat 1: fightingnuns ($419.25 in chips) 
Seat 2: otvar132 ($323.25 in chips) 
fightingnuns: posts small blind $2
otvar132: posts big blind $4
*** HOLE CARDS ***
Dealt to fightingnuns [5h Tc]
fightingnuns: folds 
Uncalled bet ($2) returned to otvar132
otvar132 collected $4 from pot
otvar132: doesn't show hand 
*** SUMMARY ***
Total pot $4 | Rake $0 
Seat 1: fightingnuns (button) (small blind) folded before Flop
Seat 2: otvar132 (big blind) collected ($4)



PokerStars Game #59914973441:  Hold'em No Limit ($2/$4 USD) - 2011/03/27 18:30:52 ET
Table 'Pulcherrima XI' 2-max Seat #2 is the button
Seat 1: fightingnuns ($417.25 in chips) 
Seat 2: otvar132 ($325.25 in chips) 
otvar132: posts small blind $2
fightingnuns: posts big blind $4
*** HOLE CARDS ***
Dealt to fightingnuns [Jd Tc]
otvar132: folds 
Uncalled bet ($2) returned to fightingnuns
fightingnuns collected $4 from pot
fightingnuns: doesn't show hand 
*** SUMMARY ***
Total pot $4 | Rake $0 
Seat 1: fightingnuns (big blind) collected ($4)
Seat 2: otvar132 (button) (small blind) folded before Flop



PokerStars Game #59914979140:  Hold'em No Limit ($2/$4 USD) - 2011/03/27 18:30:57 ET
Table 'Pulcherrima XI' 2-max Seat #1 is the button
Seat 1: fightingnuns ($419.25 in chips) 
Seat 2: otvar132 ($323.25 in chips) 
fightingnuns: posts small blind $2
otvar132: posts big blind $4
*** HOLE CARDS ***
Dealt to fightingnuns [Td Ah]
fightingnuns: raises $8 to $12
otvar132: folds 
Uncalled bet ($8) returned to fightingnuns
fightingnuns collected $8 from pot
fightingnuns: doesn't show hand 
*** SUMMARY ***
Total pot $8 | Rake $0 
Seat 1: fightingnuns (button) (small blind) collected ($8)
Seat 2: otvar132 (big blind) folded before Flop



PokerStars Game #59914986254:  Hold'em No Limit ($2/$4 USD) - 2011/03/27 18:31:05 ET
Table 'Pulcherrima XI' 2-max Seat #2 is the button
Seat 1: fightingnuns ($423.25 in chips) 
Seat 2: otvar132 ($319.25 in chips) 
otvar132: posts small blind $2
fightingnuns: posts big blind $4
*** HOLE CARDS ***
Dealt to fightingnuns [Qd 5c]
otvar132: calls $2
fightingnuns: checks 
*** FLOP *** [3h 7s Ks]
fightingnuns: bets $8
otvar132: calls $8
*** TURN *** [3h 7s Ks] [4s]
fightingnuns: checks 
otvar132: checks 
*** RIVER *** [3h 7s Ks 4s] [Jh]
fightingnuns: checks 
otvar132: bets $12
fightingnuns: folds 
Uncalled bet ($12) returned to otvar132
otvar132 collected $23.50 from pot
otvar132: doesn't show hand 
*** SUMMARY ***
Total pot $24 | Rake $0.50 
Board [3h 7s Ks 4s Jh]
Seat 1: fightingnuns (big blind) folded on the River
Seat 2: otvar132 (button) (small blind) collected ($23.50)



PokerStars Game #59915008138:  Hold'em No Limit ($2/$4 USD) - 2011/03/27 18:31:27 ET
Table 'Pulcherrima XI' 2-max Seat #1 is the button
Seat 1: fightingnuns ($411.25 in chips) 
Seat 2: otvar132 ($330.75 in chips) 
fightingnuns: posts small blind $2
otvar132: posts big blind $4
*** HOLE CARDS ***
Dealt to fightingnuns [Jc 5c]
fightingnuns: raises $8 to $12
otvar132: calls $8
*** FLOP *** [2s 6d Ah]
otvar132: checks 
fightingnuns: bets $16
otvar132: calls $16
*** TURN *** [2s 6d Ah] [Ad]
otvar132: bets $16
fightingnuns: folds 
Uncalled bet ($16) returned to otvar132
otvar132 collected $55.50 from pot
otvar132: doesn't show hand 
*** SUMMARY ***
Total pot $56 | Rake $0.50 
Board [2s 6d Ah Ad]
Seat 1: fightingnuns (button) (small blind) folded on the Turn
Seat 2: otvar132 (big blind) collected ($55.50)



PokerStars Game #59915031615:  Hold'em No Limit ($2/$4 USD) - 2011/03/27 18:31:51 ET
Table 'Pulcherrima XI' 2-max Seat #2 is the button
Seat 1: fightingnuns ($400 in chips) 
Seat 2: otvar132 ($358.25 in chips) 
otvar132: posts small blind $2
fightingnuns: posts big blind $4
*** HOLE CARDS ***
Dealt to fightingnuns [5h 9c]
otvar132: calls $2
fightingnuns: checks 
*** FLOP *** [Qd 8d 9h]
fightingnuns: checks 
otvar132: checks 
*** TURN *** [Qd 8d 9h] [Th]
fightingnuns: checks 
otvar132: checks 
*** RIVER *** [Qd 8d 9h Th] [Ks]
fightingnuns: checks 
otvar132: bets $12
fightingnuns: folds 
Uncalled bet ($12) returned to otvar132
otvar132 collected $7.60 from pot
otvar132: doesn't show hand 
*** SUMMARY ***
Total pot $8 | Rake $0.40 
Board [Qd 8d 9h Th Ks]
Seat 1: fightingnuns (big blind) folded on the River
Seat 2: otvar132 (button) (small blind) collected ($7.60)



PokerStars Game #59915050705:  Hold'em No Limit ($2/$4 USD) - 2011/03/27 18:32:10 ET
Table 'Pulcherrima XI' 2-max Seat #1 is the button
Seat 1: fightingnuns ($400 in chips) 
Seat 2: otvar132 ($361.85 in chips) 
fightingnuns: posts small blind $2
otvar132: posts big blind $4
*** HOLE CARDS ***
Dealt to fightingnuns [Ac 8d]
fightingnuns: raises $8 to $12
otvar132: calls $8
*** FLOP *** [5d 6c 9s]
otvar132: checks 
fightingnuns: checks 
*** TURN *** [5d 6c 9s] [4h]
otvar132: checks 
fightingnuns: checks 
*** RIVER *** [5d 6c 9s 4h] [Jd]
otvar132: checks 
fightingnuns: checks 
*** SHOW DOWN ***
otvar132: shows [Jc Td] (a pair of Jacks)
fightingnuns: mucks hand 
otvar132 collected $23.50 from pot
*** SUMMARY ***
Total pot $24 | Rake $0.50 
Board [5d 6c 9s 4h Jd]
Seat 1: fightingnuns (button) (small blind) mucked [Ac 8d]
Seat 2: otvar132 (big blind) showed [Jc Td] and won ($23.50) with a pair of Jacks



PokerStars Game #59915071622:  Hold'em No Limit ($2/$4 USD) - 2011/03/27 18:32:32 ET
Table 'Pulcherrima XI' 2-max Seat #2 is the button
Seat 1: fightingnuns ($400 in chips) 
Seat 2: otvar132 ($373.35 in chips) 
otvar132: posts small blind $2
fightingnuns: posts big blind $4
*** HOLE CARDS ***
Dealt to fightingnuns [9h Ah]
otvar132: calls $2
fightingnuns: raises $12 to $16
otvar132: calls $12
*** FLOP *** [7s 7h Th]
fightingnuns: bets $20
otvar132: folds 
Uncalled bet ($20) returned to fightingnuns
fightingnuns collected $31.50 from pot
fightingnuns: doesn't show hand 
*** SUMMARY ***
Total pot $32 | Rake $0.50 
Board [7s 7h Th]
Seat 1: fightingnuns (big blind) collected ($31.50)
Seat 2: otvar132 (button) (small blind) folded on the Flop



PokerStars Game #59915085907:  Hold'em No Limit ($2/$4 USD) - 2011/03/27 18:32:47 ET
Table 'Pulcherrima XI' 2-max Seat #1 is the button
Seat 1: fightingnuns ($415.50 in chips) 
Seat 2: otvar132 ($357.35 in chips) 
fightingnuns: posts small blind $2
otvar132: posts big blind $4
*** HOLE CARDS ***
Dealt to fightingnuns [9d 8s]
fightingnuns: raises $8 to $12
otvar132: folds 
Uncalled bet ($8) returned to fightingnuns
fightingnuns collected $8 from pot
fightingnuns: doesn't show hand 
*** SUMMARY ***
Total pot $8 | Rake $0 
Seat 1: fightingnuns (button) (small blind) collected ($8)
Seat 2: otvar132 (big blind) folded before Flop



PokerStars Game #59915093210:  Hold'em No Limit ($2/$4 USD) - 2011/03/27 18:32:54 ET
Table 'Pulcherrima XI' 2-max Seat #2 is the button
Seat 1: fightingnuns ($419.50 in chips) 
Seat 2: otvar132 ($353.35 in chips) 
otvar132: posts small blind $2
fightingnuns: posts big blind $4
*** HOLE CARDS ***
Dealt to fightingnuns [8s 4d]
otvar132: calls $2
fightingnuns: checks 
*** FLOP *** [5d Ac 3d]
fightingnuns: checks 
otvar132: checks 
*** TURN *** [5d Ac 3d] [Kc]
fightingnuns: checks 
otvar132: bets $8
fightingnuns: folds 
Uncalled bet ($8) returned to otvar132
otvar132 collected $7.60 from pot
otvar132: doesn't show hand 
*** SUMMARY ***
Total pot $8 | Rake $0.40 
Board [5d Ac 3d Kc]
Seat 1: fightingnuns (big blind) folded on the Turn
Seat 2: otvar132 (button) (small blind) collected ($7.60)



PokerStars Game #59915109527:  Hold'em No Limit ($2/$4 USD) - 2011/03/27 18:33:11 ET
Table 'Pulcherrima XI' 2-max Seat #1 is the button
Seat 1: fightingnuns ($415.50 in chips) 
Seat 2: otvar132 ($356.95 in chips) 
fightingnuns: posts small blind $2
otvar132: posts big blind $4
*** HOLE CARDS ***
Dealt to fightingnuns [3s Ac]
fightingnuns: raises $8 to $12
otvar132: calls $8
*** FLOP *** [2c Kd 8s]
otvar132: checks 
fightingnuns: checks 
*** TURN *** [2c Kd 8s] [4c]
otvar132: checks 
fightingnuns: checks 
*** RIVER *** [2c Kd 8s 4c] [2d]
otvar132: checks 
fightingnuns: checks 
*** SHOW DOWN ***
otvar132: shows [Ad 7c] (a pair of Deuces)
fightingnuns: shows [3s Ac] (a pair of Deuces)
otvar132 collected $11.75 from pot
fightingnuns collected $11.75 from pot
*** SUMMARY ***
Total pot $24 | Rake $0.50 
Board [2c Kd 8s 4c 2d]
Seat 1: fightingnuns (button) (small blind) showed [3s Ac] and won ($11.75) with a pair of Deuces
Seat 2: otvar132 (big blind) showed [Ad 7c] and won ($11.75) with a pair of Deuces



PokerStars Game #59915130863:  Hold'em No Limit ($2/$4 USD) - 2011/03/27 18:33:32 ET
Table 'Pulcherrima XI' 2-max Seat #2 is the button
Seat 1: fightingnuns ($415.25 in chips) 
Seat 2: otvar132 ($356.70 in chips) 
otvar132: posts small blind $2
fightingnuns: posts big blind $4
*** HOLE CARDS ***
Dealt to fightingnuns [Th 8d]
otvar132: calls $2
fightingnuns: checks 
*** FLOP *** [2c 3c 9h]
fightingnuns: checks 
otvar132: checks 
*** TURN *** [2c 3c 9h] [7h]
fightingnuns: checks 
otvar132: checks 
*** RIVER *** [2c 3c 9h 7h] [7c]
fightingnuns: checks 
otvar132: bets $4
fightingnuns: folds 
Uncalled bet ($4) returned to otvar132
otvar132 collected $7.60 from pot
otvar132: doesn't show hand 
*** SUMMARY ***
Total pot $8 | Rake $0.40 
Board [2c 3c 9h 7h 7c]
Seat 1: fightingnuns (big blind) folded on the River
Seat 2: otvar132 (button) (small blind) collected ($7.60)



PokerStars Game #59915150212:  Hold'em No Limit ($2/$4 USD) - 2011/03/27 18:33:52 ET
Table 'Pulcherrima XI' 2-max Seat #1 is the button
Seat 1: fightingnuns ($411.25 in chips) 
Seat 2: otvar132 ($360.30 in chips) 
fightingnuns: posts small blind $2
otvar132: posts big blind $4
*** HOLE CARDS ***
Dealt to fightingnuns [3d Ts]
fightingnuns: folds 
Uncalled bet ($2) returned to otvar132
otvar132 collected $4 from pot
otvar132: doesn't show hand 
*** SUMMARY ***
Total pot $4 | Rake $0 
Seat 1: fightingnuns (button) (small blind) folded before Flop
Seat 2: otvar132 (big blind) collected ($4)



PokerStars Game #59915155629:  Hold'em No Limit ($2/$4 USD) - 2011/03/27 18:33:58 ET
Table 'Pulcherrima XI' 2-max Seat #2 is the button
Seat 1: fightingnuns ($409.25 in chips) 
Seat 2: otvar132 ($362.30 in chips) 
otvar132: posts small blind $2
fightingnuns: posts big blind $4
*** HOLE CARDS ***
Dealt to fightingnuns [2c 7h]
otvar132: folds 
Uncalled bet ($2) returned to fightingnuns
fightingnuns collected $4 from pot
fightingnuns: doesn't show hand 
*** SUMMARY ***
Total pot $4 | Rake $0 
Seat 1: fightingnuns (big blind) collected ($4)
Seat 2: otvar132 (button) (small blind) folded before Flop



PokerStars Game #59915161485:  Hold'em No Limit ($2/$4 USD) - 2011/03/27 18:34:04 ET
Table 'Pulcherrima XI' 2-max Seat #1 is the button
Seat 1: fightingnuns ($411.25 in chips) 
Seat 2: otvar132 ($360.30 in chips) 
fightingnuns: posts small blind $2
otvar132: posts big blind $4
*** HOLE CARDS ***
Dealt to fightingnuns [2c Js]
fightingnuns: raises $8 to $12
otvar132: calls $8
*** FLOP *** [Ac Td Ah]
otvar132: checks 
fightingnuns: checks 
*** TURN *** [Ac Td Ah] [8d]
otvar132: checks 
fightingnuns: bets $16
otvar132: folds 
Uncalled bet ($16) returned to fightingnuns
fightingnuns collected $23.50 from pot
fightingnuns: doesn't show hand 
*** SUMMARY ***
Total pot $24 | Rake $0.50 
Board [Ac Td Ah 8d]
Seat 1: fightingnuns (button) (small blind) collected ($23.50)
Seat 2: otvar132 (big blind) folded on the Turn



PokerStars Game #59915181539:  Hold'em No Limit ($2/$4 USD) - 2011/03/27 18:34:24 ET
Table 'Pulcherrima XI' 2-max Seat #2 is the button
Seat 1: fightingnuns ($422.75 in chips) 
Seat 2: otvar132 ($348.30 in chips) 
otvar132: posts small blind $2
fightingnuns: posts big blind $4
*** HOLE CARDS ***
Dealt to fightingnuns [9c 8h]
otvar132: folds 
Uncalled bet ($2) returned to fightingnuns
fightingnuns collected $4 from pot
fightingnuns: doesn't show hand 
*** SUMMARY ***
Total pot $4 | Rake $0 
Seat 1: fightingnuns (big blind) collected ($4)
Seat 2: otvar132 (button) (small blind) folded before Flop



PokerStars Game #59915187295:  Hold'em No Limit ($2/$4 USD) - 2011/03/27 18:34:30 ET
Table 'Pulcherrima XI' 2-max Seat #1 is the button
Seat 1: fightingnuns ($424.75 in chips) 
Seat 2: otvar132 ($346.30 in chips) 
fightingnuns: posts small blind $2
otvar132: posts big blind $4
*** HOLE CARDS ***
Dealt to fightingnuns [3h Qs]
fightingnuns: folds 
Uncalled bet ($2) returned to otvar132
otvar132 collected $4 from pot
otvar132: doesn't show hand 
*** SUMMARY ***
Total pot $4 | Rake $0 
Seat 1: fightingnuns (button) (small blind) folded before Flop
Seat 2: otvar132 (big blind) collected ($4)



PokerStars Game #59915192880:  Hold'em No Limit ($2/$4 USD) - 2011/03/27 18:34:36 ET
Table 'Pulcherrima XI' 2-max Seat #2 is the button
Seat 1: fightingnuns ($422.75 in chips) 
Seat 2: otvar132 ($348.30 in chips) 
otvar132: posts small blind $2
fightingnuns: posts big blind $4
*** HOLE CARDS ***
Dealt to fightingnuns [8d 5c]
otvar132: calls $2
fightingnuns: checks 
*** FLOP *** [5s Ac 8s]
fightingnuns: bets $8
otvar132: calls $8
*** TURN *** [5s Ac 8s] [7c]
fightingnuns: bets $20
otvar132: folds 
Uncalled bet ($20) returned to fightingnuns
fightingnuns collected $23.50 from pot
fightingnuns: doesn't show hand 
*** SUMMARY ***
Total pot $24 | Rake $0.50 
Board [5s Ac 8s 7c]
Seat 1: fightingnuns (big blind) collected ($23.50)
Seat 2: otvar132 (button) (small blind) folded on the Turn



PokerStars Game #59915215056:  Hold'em No Limit ($2/$4 USD) - 2011/03/27 18:34:59 ET
Table 'Pulcherrima XI' 2-max Seat #1 is the button
Seat 1: fightingnuns ($434.25 in chips) 
Seat 2: otvar132 ($336.30 in chips) 
fightingnuns: posts small blind $2
otvar132: posts big blind $4
*** HOLE CARDS ***
Dealt to fightingnuns [8h Ts]
fightingnuns: raises $8 to $12
otvar132: calls $8
*** FLOP *** [2d Kd Jc]
otvar132: checks 
fightingnuns: checks 
*** TURN *** [2d Kd Jc] [9s]
otvar132: checks 
fightingnuns: bets $16
otvar132: calls $16
*** RIVER *** [2d Kd Jc 9s] [Ac]
otvar132: bets $16
fightingnuns: folds 
Uncalled bet ($16) returned to otvar132
otvar132 collected $55.50 from pot
otvar132: doesn't show hand 
*** SUMMARY ***
Total pot $56 | Rake $0.50 
Board [2d Kd Jc 9s Ac]
Seat 1: fightingnuns (button) (small blind) folded on the River
Seat 2: otvar132 (big blind) collected ($55.50)



PokerStars Game #59915243961:  Hold'em No Limit ($2/$4 USD) - 2011/03/27 18:35:28 ET
Table 'Pulcherrima XI' 2-max Seat #2 is the button
Seat 1: fightingnuns ($406.25 in chips) 
Seat 2: otvar132 ($363.80 in chips) 
otvar132: posts small blind $2
fightingnuns: posts big blind $4
*** HOLE CARDS ***
Dealt to fightingnuns [Kh Jh]
otvar132: calls $2
fightingnuns: raises $12 to $16
otvar132: calls $12
*** FLOP *** [Ah 2d 8c]
fightingnuns: checks 
otvar132: checks 
*** TURN *** [Ah 2d 8c] [Jd]
fightingnuns: bets $16
otvar132: calls $16
*** RIVER *** [Ah 2d 8c Jd] [As]
fightingnuns: bets $40
otvar132: calls $40
*** SHOW DOWN ***
fightingnuns: shows [Kh Jh] (two pair, Aces and Jacks)
otvar132: mucks hand 
fightingnuns collected $143.50 from pot
*** SUMMARY ***
Total pot $144 | Rake $0.50 
Board [Ah 2d 8c Jd As]
Seat 1: fightingnuns (big blind) showed [Kh Jh] and won ($143.50) with two pair, Aces and Jacks
Seat 2: otvar132 (button) (small blind) mucked [4h Js]



PokerStars Game #59915274763:  Hold'em No Limit ($2/$4 USD) - 2011/03/27 18:36:00 ET
Table 'Pulcherrima XI' 2-max Seat #1 is the button
Seat 1: fightingnuns ($477.75 in chips) 
Seat 2: otvar132 ($291.80 in chips) 
fightingnuns: posts small blind $2
otvar132: posts big blind $4
*** HOLE CARDS ***
Dealt to fightingnuns [Jh 3d]
fightingnuns: folds 
Uncalled bet ($2) returned to otvar132
otvar132 collected $4 from pot
otvar132: doesn't show hand 
*** SUMMARY ***
Total pot $4 | Rake $0 
Seat 1: fightingnuns (button) (small blind) folded before Flop
Seat 2: otvar132 (big blind) collected ($4)



PokerStars Game #59915280281:  Hold'em No Limit ($2/$4 USD) - 2011/03/27 18:36:05 ET
Table 'Pulcherrima XI' 2-max Seat #2 is the button
Seat 1: fightingnuns ($475.75 in chips) 
Seat 2: otvar132 ($293.80 in chips) 
otvar132: posts small blind $2
fightingnuns: posts big blind $4
*** HOLE CARDS ***
Dealt to fightingnuns [7s 2h]
otvar132: calls $2
fightingnuns: checks 
*** FLOP *** [Ks Qh 5d]
fightingnuns: checks 
otvar132: checks 
*** TURN *** [Ks Qh 5d] [6d]
fightingnuns: checks 
otvar132: bets $12
fightingnuns: folds 
Uncalled bet ($12) returned to otvar132
otvar132 collected $7.60 from pot
otvar132: doesn't show hand 
*** SUMMARY ***
Total pot $8 | Rake $0.40 
Board [Ks Qh 5d 6d]
Seat 1: fightingnuns (big blind) folded on the Turn
Seat 2: otvar132 (button) (small blind) collected ($7.60)



PokerStars Game #59915295231:  Hold'em No Limit ($2/$4 USD) - 2011/03/27 18:36:21 ET
Table 'Pulcherrima XI' 2-max Seat #1 is the button
Seat 1: fightingnuns ($471.75 in chips) 
Seat 2: otvar132 ($297.40 in chips) 
fightingnuns: posts small blind $2
otvar132: posts big blind $4
*** HOLE CARDS ***
Dealt to fightingnuns [Qd 4d]
fightingnuns: raises $8 to $12
otvar132: calls $8
*** FLOP *** [5s 7s 9c]
otvar132: checks 
fightingnuns: checks 
*** TURN *** [5s 7s 9c] [3s]
otvar132: bets $8
fightingnuns: folds 
Uncalled bet ($8) returned to otvar132
otvar132 collected $23.50 from pot
otvar132: doesn't show hand 
*** SUMMARY ***
Total pot $24 | Rake $0.50 
Board [5s 7s 9c 3s]
Seat 1: fightingnuns (button) (small blind) folded on the Turn
Seat 2: otvar132 (big blind) collected ($23.50)



PokerStars Game #59915311838:  Hold'em No Limit ($2/$4 USD) - 2011/03/27 18:36:38 ET
Table 'Pulcherrima XI' 2-max Seat #2 is the button
Seat 1: fightingnuns ($459.75 in chips) 
Seat 2: otvar132 ($308.90 in chips) 
otvar132: posts small blind $2
fightingnuns: posts big blind $4
*** HOLE CARDS ***
Dealt to fightingnuns [9c Qs]
otvar132: folds 
Uncalled bet ($2) returned to fightingnuns
fightingnuns collected $4 from pot
fightingnuns: doesn't show hand 
*** SUMMARY ***
Total pot $4 | Rake $0 
Seat 1: fightingnuns (big blind) collected ($4)
Seat 2: otvar132 (button) (small blind) folded before Flop



PokerStars Game #59915318050:  Hold'em No Limit ($2/$4 USD) - 2011/03/27 18:36:44 ET
Table 'Pulcherrima XI' 2-max Seat #1 is the button
Seat 1: fightingnuns ($461.75 in chips) 
Seat 2: otvar132 ($306.90 in chips) 
fightingnuns: posts small blind $2
otvar132: posts big blind $4
*** HOLE CARDS ***
Dealt to fightingnuns [3d 4c]
fightingnuns: folds 
Uncalled bet ($2) returned to otvar132
otvar132 collected $4 from pot
otvar132: doesn't show hand 
*** SUMMARY ***
Total pot $4 | Rake $0 
Seat 1: fightingnuns (button) (small blind) folded before Flop
Seat 2: otvar132 (big blind) collected ($4)



PokerStars Game #59915323187:  Hold'em No Limit ($2/$4 USD) - 2011/03/27 18:36:49 ET
Table 'Pulcherrima XI' 2-max Seat #2 is the button
Seat 1: fightingnuns ($459.75 in chips) 
Seat 2: otvar132 ($308.90 in chips) 
otvar132: posts small blind $2
fightingnuns: posts big blind $4
*** HOLE CARDS ***
Dealt to fightingnuns [Js 9c]
otvar132: folds 
Uncalled bet ($2) returned to fightingnuns
fightingnuns collected $4 from pot
fightingnuns: doesn't show hand 
*** SUMMARY ***
Total pot $4 | Rake $0 
Seat 1: fightingnuns (big blind) collected ($4)
Seat 2: otvar132 (button) (small blind) folded before Flop



PokerStars Game #59915328968:  Hold'em No Limit ($2/$4 USD) - 2011/03/27 18:36:55 ET
Table 'Pulcherrima XI' 2-max Seat #1 is the button
Seat 1: fightingnuns ($461.75 in chips) 
Seat 2: otvar132 ($306.90 in chips) 
fightingnuns: posts small blind $2
otvar132: posts big blind $4
*** HOLE CARDS ***
Dealt to fightingnuns [Tc Js]
fightingnuns: raises $8 to $12
otvar132: calls $8
*** FLOP *** [7d Ad Qs]
otvar132: checks 
fightingnuns: checks 
*** TURN *** [7d Ad Qs] [Kd]
otvar132: checks 
fightingnuns: bets $20
otvar132: calls $20
*** RIVER *** [7d Ad Qs Kd] [Kc]
otvar132: bets $36
fightingnuns: raises $76 to $112
otvar132: calls $76
*** SHOW DOWN ***
fightingnuns: shows [Tc Js] (a straight, Ten to Ace)
otvar132: mucks hand 
fightingnuns collected $287.50 from pot
*** SUMMARY ***
Total pot $288 | Rake $0.50 
Board [7d Ad Qs Kd Kc]
Seat 1: fightingnuns (button) (small blind) showed [Tc Js] and won ($287.50) with a straight, Ten to Ace
Seat 2: otvar132 (big blind) mucked [Ac 7h]



PokerStars Game #59915365229:  Hold'em No Limit ($2/$4 USD) - 2011/03/27 18:37:33 ET
Table 'Pulcherrima XI' 2-max Seat #2 is the button
Seat 1: fightingnuns ($605.25 in chips) 
Seat 2: otvar132 ($162.90 in chips) 
otvar132: posts small blind $2
fightingnuns: posts big blind $4
*** HOLE CARDS ***
Dealt to fightingnuns [7c 9s]
otvar132: folds 
Uncalled bet ($2) returned to fightingnuns
fightingnuns collected $4 from pot
fightingnuns: doesn't show hand 
*** SUMMARY ***
Total pot $4 | Rake $0 
Seat 1: fightingnuns (big blind) collected ($4)
Seat 2: otvar132 (button) (small blind) folded before Flop



PokerStars Game #59915370876:  Hold'em No Limit ($2/$4 USD) - 2011/03/27 18:37:39 ET
Table 'Pulcherrima XI' 2-max Seat #1 is the button
Seat 1: fightingnuns ($607.25 in chips) 
Seat 2: otvar132 ($160.90 in chips) 
fightingnuns: posts small blind $2
otvar132: posts big blind $4
*** HOLE CARDS ***
Dealt to fightingnuns [6d 6c]
fightingnuns: raises $8 to $12
otvar132: calls $8
*** FLOP *** [8h Kh 5c]
otvar132: checks 
fightingnuns: checks 
*** TURN *** [8h Kh 5c] [2d]
otvar132: checks 
fightingnuns: bets $16
otvar132: calls $16
*** RIVER *** [8h Kh 5c 2d] [7h]
otvar132: checks 
fightingnuns: checks 
*** SHOW DOWN ***
otvar132: shows [Ah Qs] (high card Ace)
fightingnuns: shows [6d 6c] (a pair of Sixes)
fightingnuns collected $55.50 from pot
*** SUMMARY ***
Total pot $56 | Rake $0.50 
Board [8h Kh 5c 2d 7h]
Seat 1: fightingnuns (button) (small blind) showed [6d 6c] and won ($55.50) with a pair of Sixes
Seat 2: otvar132 (big blind) showed [Ah Qs] and lost with high card Ace



PokerStars Game #59915394151:  Hold'em No Limit ($2/$4 USD) - 2011/03/27 18:38:03 ET
Table 'Pulcherrima XI' 2-max Seat #2 is the button
Seat 1: fightingnuns ($634.75 in chips) 
Seat 2: otvar132 ($132.90 in chips) 
otvar132: posts small blind $2
fightingnuns: posts big blind $4
*** HOLE CARDS ***
Dealt to fightingnuns [5s 7c]
otvar132: calls $2
fightingnuns: checks 
*** FLOP *** [2c Jh 4h]
fightingnuns: checks 
otvar132: checks 
*** TURN *** [2c Jh 4h] [Ks]
fightingnuns: checks 
otvar132: checks 
*** RIVER *** [2c Jh 4h Ks] [Th]
fightingnuns: bets $8
otvar132: folds 
Uncalled bet ($8) returned to fightingnuns
fightingnuns collected $7.60 from pot
fightingnuns: doesn't show hand 
*** SUMMARY ***
Total pot $8 | Rake $0.40 
Board [2c Jh 4h Ks Th]
Seat 1: fightingnuns (big blind) collected ($7.60)
Seat 2: otvar132 (button) (small blind) folded on the River



PokerStars Game #59915411897:  Hold'em No Limit ($2/$4 USD) - 2011/03/27 18:38:21 ET
Table 'Pulcherrima XI' 2-max Seat #1 is the button
Seat 1: fightingnuns ($638.35 in chips) 
Seat 2: otvar132 ($128.90 in chips) 
fightingnuns: posts small blind $2
otvar132: posts big blind $4
*** HOLE CARDS ***
Dealt to fightingnuns [Kd Tc]
fightingnuns: raises $8 to $12
otvar132: raises $20 to $32
fightingnuns: calls $20
*** FLOP *** [As 2h 7d]
otvar132: bets $32
fightingnuns: folds 
Uncalled bet ($32) returned to otvar132
otvar132 collected $63.50 from pot
otvar132: doesn't show hand 
*** SUMMARY ***
Total pot $64 | Rake $0.50 
Board [As 2h 7d]
Seat 1: fightingnuns (button) (small blind) folded on the Flop
Seat 2: otvar132 (big blind) collected ($63.50)



PokerStars Game #59915427902:  Hold'em No Limit ($2/$4 USD) - 2011/03/27 18:38:37 ET
Table 'Pulcherrima XI' 2-max Seat #2 is the button
Seat 1: fightingnuns ($606.35 in chips) 
Seat 2: otvar132 ($160.40 in chips) 
otvar132: posts small blind $2
fightingnuns: posts big blind $4
*** HOLE CARDS ***
Dealt to fightingnuns [Ks 8s]
otvar132: calls $2
fightingnuns: raises $12 to $16
otvar132: calls $12
*** FLOP *** [Js Jc Qs]
fightingnuns: bets $20
otvar132: calls $20
*** TURN *** [Js Jc Qs] [5c]
fightingnuns: bets $40
otvar132: raises $84.40 to $124.40 and is all-in
fightingnuns: folds 
Uncalled bet ($84.40) returned to otvar132
otvar132 collected $151.50 from pot
otvar132: doesn't show hand 
*** SUMMARY ***
Total pot $152 | Rake $0.50 
Board [Js Jc Qs 5c]
Seat 1: fightingnuns (big blind) folded on the Turn
Seat 2: otvar132 (button) (small blind) collected ($151.50)



PokerStars Game #59915451240:  Hold'em No Limit ($2/$4 USD) - 2011/03/27 18:39:01 ET
Table 'Pulcherrima XI' 2-max Seat #1 is the button
Seat 1: fightingnuns ($530.35 in chips) 
Seat 2: otvar132 ($235.90 in chips) 
fightingnuns: posts small blind $2
otvar132: posts big blind $4
*** HOLE CARDS ***
Dealt to fightingnuns [8d Qh]
fightingnuns: raises $8 to $12
otvar132: folds 
Uncalled bet ($8) returned to fightingnuns
fightingnuns collected $8 from pot
fightingnuns: doesn't show hand 
*** SUMMARY ***
Total pot $8 | Rake $0 
Seat 1: fightingnuns (button) (small blind) collected ($8)
Seat 2: otvar132 (big blind) folded before Flop



PokerStars Game #59915458931:  Hold'em No Limit ($2/$4 USD) - 2011/03/27 18:39:09 ET
Table 'Pulcherrima XI' 2-max Seat #2 is the button
Seat 1: fightingnuns ($534.35 in chips) 
Seat 2: otvar132 ($231.90 in chips) 
otvar132: posts small blind $2
fightingnuns: posts big blind $4
*** HOLE CARDS ***
Dealt to fightingnuns [Kh 8c]
otvar132: calls $2
fightingnuns: checks 
*** FLOP *** [Js Qc 2h]
fightingnuns: checks 
otvar132: checks 
*** TURN *** [Js Qc 2h] [Jc]
fightingnuns: checks 
otvar132: checks 
*** RIVER *** [Js Qc 2h Jc] [7c]
fightingnuns: checks 
otvar132: bets $40
fightingnuns: folds 
Uncalled bet ($40) returned to otvar132
otvar132 collected $7.60 from pot
otvar132: doesn't show hand 
*** SUMMARY ***
Total pot $8 | Rake $0.40 
Board [Js Qc 2h Jc 7c]
Seat 1: fightingnuns (big blind) folded on the River
Seat 2: otvar132 (button) (small blind) collected ($7.60)



PokerStars Game #59915476885:  Hold'em No Limit ($2/$4 USD) - 2011/03/27 18:39:28 ET
Table 'Pulcherrima XI' 2-max Seat #1 is the button
Seat 1: fightingnuns ($530.35 in chips) 
Seat 2: otvar132 ($235.50 in chips) 
fightingnuns: posts small blind $2
otvar132: posts big blind $4
*** HOLE CARDS ***
Dealt to fightingnuns [As Tc]
fightingnuns: raises $8 to $12
otvar132: folds 
Uncalled bet ($8) returned to fightingnuns
fightingnuns collected $8 from pot
fightingnuns: doesn't show hand 
*** SUMMARY ***
Total pot $8 | Rake $0 
Seat 1: fightingnuns (button) (small blind) collected ($8)
Seat 2: otvar132 (big blind) folded before Flop



PokerStars Game #59915483288:  Hold'em No Limit ($2/$4 USD) - 2011/03/27 18:39:34 ET
Table 'Pulcherrima XI' 2-max Seat #2 is the button
Seat 1: fightingnuns ($534.35 in chips) 
Seat 2: otvar132 ($231.50 in chips) 
otvar132: posts small blind $2
fightingnuns: posts big blind $4
*** HOLE CARDS ***
Dealt to fightingnuns [6c 5d]
otvar132: calls $2
fightingnuns: checks 
*** FLOP *** [8s 9h 5h]
fightingnuns: checks 
otvar132: checks 
*** TURN *** [8s 9h 5h] [7h]
fightingnuns: bets $8
otvar132: folds 
Uncalled bet ($8) returned to fightingnuns
fightingnuns collected $7.60 from pot
fightingnuns: doesn't show hand 
*** SUMMARY ***
Total pot $8 | Rake $0.40 
Board [8s 9h 5h 7h]
Seat 1: fightingnuns (big blind) collected ($7.60)
Seat 2: otvar132 (button) (small blind) folded on the Turn



PokerStars Game #59915501391:  Hold'em No Limit ($2/$4 USD) - 2011/03/27 18:39:53 ET
Table 'Pulcherrima XI' 2-max Seat #1 is the button
Seat 1: fightingnuns ($537.95 in chips) 
Seat 2: otvar132 ($227.50 in chips) 
fightingnuns: posts small blind $2
otvar132: posts big blind $4
*** HOLE CARDS ***
Dealt to fightingnuns [5d 5s]
fightingnuns: raises $8 to $12
otvar132: raises $16 to $28
fightingnuns: calls $16
*** FLOP *** [8s 2c Kd]
otvar132: bets $20
fightingnuns: folds 
Uncalled bet ($20) returned to otvar132
otvar132 collected $55.50 from pot
otvar132: doesn't show hand 
*** SUMMARY ***
Total pot $56 | Rake $0.50 
Board [8s 2c Kd]
Seat 1: fightingnuns (button) (small blind) folded on the Flop
Seat 2: otvar132 (big blind) collected ($55.50)



PokerStars Game #59915517554:  Hold'em No Limit ($2/$4 USD) - 2011/03/27 18:40:10 ET
Table 'Pulcherrima XI' 2-max Seat #2 is the button
Seat 1: fightingnuns ($509.95 in chips) 
Seat 2: otvar132 ($255 in chips) 
otvar132: posts small blind $2
fightingnuns: posts big blind $4
*** HOLE CARDS ***
Dealt to fightingnuns [9c 6h]
otvar132: folds 
Uncalled bet ($2) returned to fightingnuns
fightingnuns collected $4 from pot
fightingnuns: doesn't show hand 
*** SUMMARY ***
Total pot $4 | Rake $0 
Seat 1: fightingnuns (big blind) collected ($4)
Seat 2: otvar132 (button) (small blind) folded before Flop



PokerStars Game #59915523633:  Hold'em No Limit ($2/$4 USD) - 2011/03/27 18:40:16 ET
Table 'Pulcherrima XI' 2-max Seat #1 is the button
Seat 1: fightingnuns ($511.95 in chips) 
Seat 2: otvar132 ($253 in chips) 
fightingnuns: posts small blind $2
otvar132: posts big blind $4
*** HOLE CARDS ***
Dealt to fightingnuns [2c 9c]
fightingnuns: folds 
Uncalled bet ($2) returned to otvar132
otvar132 collected $4 from pot
otvar132: doesn't show hand 
*** SUMMARY ***
Total pot $4 | Rake $0 
Seat 1: fightingnuns (button) (small blind) folded before Flop
Seat 2: otvar132 (big blind) collected ($4)



PokerStars Game #59915529739:  Hold'em No Limit ($2/$4 USD) - 2011/03/27 18:40:22 ET
Table 'Pulcherrima XI' 2-max Seat #2 is the button
Seat 1: fightingnuns ($509.95 in chips) 
Seat 2: otvar132 ($255 in chips) 
otvar132: posts small blind $2
fightingnuns: posts big blind $4
*** HOLE CARDS ***
Dealt to fightingnuns [3c Kc]
otvar132: calls $2
fightingnuns: checks 
*** FLOP *** [9h Qs Kd]
fightingnuns: bets $8
otvar132: calls $8
*** TURN *** [9h Qs Kd] [7d]
fightingnuns: bets $28
otvar132: calls $28
*** RIVER *** [9h Qs Kd 7d] [5c]
fightingnuns: checks 
otvar132: checks 
*** SHOW DOWN ***
fightingnuns: shows [3c Kc] (a pair of Kings)
otvar132: shows [Ks 8d] (a pair of Kings - Queen+Nine+Eight kicker)
otvar132 collected $79.50 from pot
*** SUMMARY ***
Total pot $80 | Rake $0.50 
Board [9h Qs Kd 7d 5c]
Seat 1: fightingnuns (big blind) showed [3c Kc] and lost with a pair of Kings
Seat 2: otvar132 (button) (small blind) showed [Ks 8d] and won ($79.50) with a pair of Kings



PokerStars Game #59915549959:  Hold'em No Limit ($2/$4 USD) - 2011/03/27 18:40:43 ET
Table 'Pulcherrima XI' 2-max Seat #1 is the button
Seat 1: fightingnuns ($469.95 in chips) 
Seat 2: otvar132 ($294.50 in chips) 
fightingnuns: posts small blind $2
otvar132: posts big blind $4
*** HOLE CARDS ***
Dealt to fightingnuns [Jh Tc]
fightingnuns: raises $8 to $12
otvar132: calls $8
*** FLOP *** [8c 7c 6d]
otvar132: bets $16
fightingnuns: folds 
Uncalled bet ($16) returned to otvar132
otvar132 collected $23.50 from pot
otvar132: doesn't show hand 
*** SUMMARY ***
Total pot $24 | Rake $0.50 
Board [8c 7c 6d]
Seat 1: fightingnuns (button) (small blind) folded on the Flop
Seat 2: otvar132 (big blind) collected ($23.50)



PokerStars Game #59915564044:  Hold'em No Limit ($2/$4 USD) - 2011/03/27 18:40:58 ET
Table 'Pulcherrima XI' 2-max Seat #2 is the button
Seat 1: fightingnuns ($457.95 in chips) 
Seat 2: otvar132 ($306 in chips) 
otvar132: posts small blind $2
fightingnuns: posts big blind $4
*** HOLE CARDS ***
Dealt to fightingnuns [3c Jc]
otvar132: calls $2
fightingnuns: checks 
*** FLOP *** [Kh Td Jh]
fightingnuns: checks 
otvar132: checks 
*** TURN *** [Kh Td Jh] [Ah]
fightingnuns: checks 
otvar132: checks 
*** RIVER *** [Kh Td Jh Ah] [Qh]
fightingnuns: checks 
otvar132: bets $20
fightingnuns: folds 
Uncalled bet ($20) returned to otvar132
otvar132 collected $7.60 from pot
otvar132: doesn't show hand 
*** SUMMARY ***
Total pot $8 | Rake $0.40 
Board [Kh Td Jh Ah Qh]
Seat 1: fightingnuns (big blind) folded on the River
Seat 2: otvar132 (button) (small blind) collected ($7.60)



PokerStars Game #59915581785:  Hold'em No Limit ($2/$4 USD) - 2011/03/27 18:41:16 ET
Table 'Pulcherrima XI' 2-max Seat #1 is the button
Seat 1: fightingnuns ($453.95 in chips) 
Seat 2: otvar132 ($309.60 in chips) 
fightingnuns: posts small blind $2
otvar132: posts big blind $4
*** HOLE CARDS ***
Dealt to fightingnuns [Qh 8c]
fightingnuns: raises $8 to $12
otvar132: folds 
Uncalled bet ($8) returned to fightingnuns
fightingnuns collected $8 from pot
fightingnuns: doesn't show hand 
*** SUMMARY ***
Total pot $8 | Rake $0 
Seat 1: fightingnuns (button) (small blind) collected ($8)
Seat 2: otvar132 (big blind) folded before Flop



PokerStars Game #59915588505:  Hold'em No Limit ($2/$4 USD) - 2011/03/27 18:41:23 ET
Table 'Pulcherrima XI' 2-max Seat #2 is the button
Seat 1: fightingnuns ($457.95 in chips) 
Seat 2: otvar132 ($305.60 in chips) 
otvar132: posts small blind $2
fightingnuns: posts big blind $4
*** HOLE CARDS ***
Dealt to fightingnuns [Qc Th]
otvar132: calls $2
fightingnuns: raises $20 to $24
otvar132: calls $20
*** FLOP *** [Jd Td 3d]
fightingnuns: bets $28
otvar132: folds 
Uncalled bet ($28) returned to fightingnuns
fightingnuns collected $47.50 from pot
fightingnuns: doesn't show hand 
*** SUMMARY ***
Total pot $48 | Rake $0.50 
Board [Jd Td 3d]
Seat 1: fightingnuns (big blind) collected ($47.50)
Seat 2: otvar132 (button) (small blind) folded on the Flop



PokerStars Game #59915605892:  Hold'em No Limit ($2/$4 USD) - 2011/03/27 18:41:42 ET
Table 'Pulcherrima XI' 2-max Seat #1 is the button
Seat 1: fightingnuns ($481.45 in chips) 
Seat 2: otvar132 ($281.60 in chips) 
fightingnuns: posts small blind $2
otvar132: posts big blind $4
*** HOLE CARDS ***
Dealt to fightingnuns [7d 6c]
fightingnuns: raises $8 to $12
otvar132: calls $8
*** FLOP *** [8c 9s Ah]
otvar132: checks 
fightingnuns: bets $16
otvar132: folds 
Uncalled bet ($16) returned to fightingnuns
fightingnuns collected $23.50 from pot
fightingnuns: doesn't show hand 
*** SUMMARY ***
Total pot $24 | Rake $0.50 
Board [8c 9s Ah]
Seat 1: fightingnuns (button) (small blind) collected ($23.50)
Seat 2: otvar132 (big blind) folded on the Flop



PokerStars Game #59915621960:  Hold'em No Limit ($2/$4 USD) - 2011/03/27 18:41:58 ET
Table 'Pulcherrima XI' 2-max Seat #2 is the button
Seat 1: fightingnuns ($492.95 in chips) 
Seat 2: otvar132 ($269.60 in chips) 
otvar132: posts small blind $2
fightingnuns: posts big blind $4
*** HOLE CARDS ***
Dealt to fightingnuns [Ad 3h]
otvar132: folds 
Uncalled bet ($2) returned to fightingnuns
fightingnuns collected $4 from pot
fightingnuns: doesn't show hand 
*** SUMMARY ***
Total pot $4 | Rake $0 
Seat 1: fightingnuns (big blind) collected ($4)
Seat 2: otvar132 (button) (small blind) folded before Flop



PokerStars Game #59915631387:  Hold'em No Limit ($2/$4 USD) - 2011/03/27 18:42:07 ET
Table 'Pulcherrima XI' 2-max Seat #1 is the button
Seat 1: fightingnuns ($494.95 in chips) 
Seat 2: otvar132 ($267.60 in chips) 
fightingnuns: posts small blind $2
otvar132: posts big blind $4
*** HOLE CARDS ***
Dealt to fightingnuns [Ks 7d]
fightingnuns: raises $8 to $12
otvar132: raises $8 to $20
fightingnuns: calls $8
*** FLOP *** [5h Th 5c]
otvar132: bets $12
fightingnuns: folds 
Uncalled bet ($12) returned to otvar132
otvar132 collected $39.50 from pot
otvar132: doesn't show hand 
*** SUMMARY ***
Total pot $40 | Rake $0.50 
Board [5h Th 5c]
Seat 1: fightingnuns (button) (small blind) folded on the Flop
Seat 2: otvar132 (big blind) collected ($39.50)



PokerStars Game #59915648891:  Hold'em No Limit ($2/$4 USD) - 2011/03/27 18:42:26 ET
Table 'Pulcherrima XI' 2-max Seat #2 is the button
Seat 1: fightingnuns ($474.95 in chips) 
Seat 2: otvar132 ($287.10 in chips) 
otvar132: posts small blind $2
fightingnuns: posts big blind $4
*** HOLE CARDS ***
Dealt to fightingnuns [Kh Tc]
otvar132: calls $2
fightingnuns: raises $12 to $16
otvar132: calls $12
*** FLOP *** [2d 5d Qc]
fightingnuns: checks 
otvar132: checks 
*** TURN *** [2d 5d Qc] [4h]
fightingnuns: checks 
otvar132: checks 
*** RIVER *** [2d 5d Qc 4h] [7d]
fightingnuns: checks 
otvar132: bets $8
fightingnuns: folds 
Uncalled bet ($8) returned to otvar132
otvar132 collected $31.50 from pot
otvar132: doesn't show hand 
*** SUMMARY ***
Total pot $32 | Rake $0.50 
Board [2d 5d Qc 4h 7d]
Seat 1: fightingnuns (big blind) folded on the River
Seat 2: otvar132 (button) (small blind) collected ($31.50)



PokerStars Game #59915673415:  Hold'em No Limit ($2/$4 USD) - 2011/03/27 18:42:51 ET
Table 'Pulcherrima XI' 2-max Seat #1 is the button
Seat 1: fightingnuns ($458.95 in chips) 
Seat 2: otvar132 ($302.60 in chips) 
fightingnuns: posts small blind $2
otvar132: posts big blind $4
*** HOLE CARDS ***
Dealt to fightingnuns [7s Qs]
fightingnuns: raises $8 to $12
otvar132: calls $8
*** FLOP *** [3s 2d Qd]
otvar132: checks 
fightingnuns: bets $16
otvar132: folds 
Uncalled bet ($16) returned to fightingnuns
fightingnuns collected $23.50 from pot
fightingnuns: doesn't show hand 
*** SUMMARY ***
Total pot $24 | Rake $0.50 
Board [3s 2d Qd]
Seat 1: fightingnuns (button) (small blind) collected ($23.50)
Seat 2: otvar132 (big blind) folded on the Flop



PokerStars Game #59915689363:  Hold'em No Limit ($2/$4 USD) - 2011/03/27 18:43:08 ET
Table 'Pulcherrima XI' 2-max Seat #2 is the button
Seat 1: fightingnuns ($470.45 in chips) 
Seat 2: otvar132 ($290.60 in chips) 
otvar132: posts small blind $2
fightingnuns: posts big blind $4
*** HOLE CARDS ***
Dealt to fightingnuns [9c Th]
otvar132: folds 
Uncalled bet ($2) returned to fightingnuns
fightingnuns collected $4 from pot
fightingnuns: doesn't show hand 
*** SUMMARY ***
Total pot $4 | Rake $0 
Seat 1: fightingnuns (big blind) collected ($4)
Seat 2: otvar132 (button) (small blind) folded before Flop



PokerStars Game #59915694764:  Hold'em No Limit ($2/$4 USD) - 2011/03/27 18:43:13 ET
Table 'Pulcherrima XI' 2-max Seat #1 is the button
Seat 1: fightingnuns ($472.45 in chips) 
Seat 2: otvar132 ($288.60 in chips) 
fightingnuns: posts small blind $2
otvar132: posts big blind $4
*** HOLE CARDS ***
Dealt to fightingnuns [Tc Qh]
fightingnuns: raises $8 to $12
otvar132: calls $8
*** FLOP *** [Jh 6s 2c]
otvar132: bets $12
fightingnuns: calls $12
*** TURN *** [Jh 6s 2c] [4d]
otvar132: bets $12
fightingnuns: folds 
Uncalled bet ($12) returned to otvar132
otvar132 collected $47.50 from pot
otvar132: doesn't show hand 
*** SUMMARY ***
Total pot $48 | Rake $0.50 
Board [Jh 6s 2c 4d]
Seat 1: fightingnuns (button) (small blind) folded on the Turn
Seat 2: otvar132 (big blind) collected ($47.50)



PokerStars Game #59915713844:  Hold'em No Limit ($2/$4 USD) - 2011/03/27 18:43:34 ET
Table 'Pulcherrima XI' 2-max Seat #2 is the button
Seat 1: fightingnuns ($448.45 in chips) 
Seat 2: otvar132 ($312.10 in chips) 
otvar132: posts small blind $2
fightingnuns: posts big blind $4
*** HOLE CARDS ***
Dealt to fightingnuns [4d 6c]
otvar132: raises $12 to $16
fightingnuns: folds 
Uncalled bet ($12) returned to otvar132
otvar132 collected $8 from pot
otvar132: doesn't show hand 
*** SUMMARY ***
Total pot $8 | Rake $0 
Seat 1: fightingnuns (big blind) folded before Flop
Seat 2: otvar132 (button) (small blind) collected ($8)



PokerStars Game #59915721408:  Hold'em No Limit ($2/$4 USD) - 2011/03/27 18:43:42 ET
Table 'Pulcherrima XI' 2-max Seat #1 is the button
Seat 1: fightingnuns ($444.45 in chips) 
Seat 2: otvar132 ($316.10 in chips) 
fightingnuns: posts small blind $2
otvar132: posts big blind $4
*** HOLE CARDS ***
Dealt to fightingnuns [Td Jc]
fightingnuns: raises $8 to $12
otvar132: calls $8
*** FLOP *** [Ah 7s 8s]
otvar132: checks 
fightingnuns: checks 
*** TURN *** [Ah 7s 8s] [2h]
otvar132: checks 
fightingnuns: bets $16
otvar132: folds 
Uncalled bet ($16) returned to fightingnuns
fightingnuns collected $23.50 from pot
fightingnuns: doesn't show hand 
*** SUMMARY ***
Total pot $24 | Rake $0.50 
Board [Ah 7s 8s 2h]
Seat 1: fightingnuns (button) (small blind) collected ($23.50)
Seat 2: otvar132 (big blind) folded on the Turn



PokerStars Game #59915741534:  Hold'em No Limit ($2/$4 USD) - 2011/03/27 18:44:03 ET
Table 'Pulcherrima XI' 2-max Seat #2 is the button
Seat 1: fightingnuns ($455.95 in chips) 
Seat 2: otvar132 ($304.10 in chips) 
otvar132: posts small blind $2
fightingnuns: posts big blind $4
*** HOLE CARDS ***
Dealt to fightingnuns [9d Th]
otvar132: folds 
Uncalled bet ($2) returned to fightingnuns
fightingnuns collected $4 from pot
fightingnuns: doesn't show hand 
*** SUMMARY ***
Total pot $4 | Rake $0 
Seat 1: fightingnuns (big blind) collected ($4)
Seat 2: otvar132 (button) (small blind) folded before Flop



PokerStars Game #59915746964:  Hold'em No Limit ($2/$4 USD) - 2011/03/27 18:44:08 ET
Table 'Pulcherrima XI' 2-max Seat #1 is the button
Seat 1: fightingnuns ($457.95 in chips) 
Seat 2: otvar132 ($302.10 in chips) 
fightingnuns: posts small blind $2
otvar132: posts big blind $4
*** HOLE CARDS ***
Dealt to fightingnuns [Jd 8s]
fightingnuns: raises $8 to $12
otvar132: calls $8
*** FLOP *** [2h 3h Ad]
otvar132: checks 
fightingnuns: bets $16
otvar132: calls $16
*** TURN *** [2h 3h Ad] [7d]
otvar132: checks 
fightingnuns: checks 
*** RIVER *** [2h 3h Ad 7d] [Ah]
otvar132: checks 
fightingnuns: checks 
*** SHOW DOWN ***
otvar132: shows [Js 4s] (a pair of Aces)
fightingnuns: shows [Jd 8s] (a pair of Aces - Jack+Eight kicker)
fightingnuns collected $55.50 from pot
*** SUMMARY ***
Total pot $56 | Rake $0.50 
Board [2h 3h Ad 7d Ah]
Seat 1: fightingnuns (button) (small blind) showed [Jd 8s] and won ($55.50) with a pair of Aces
Seat 2: otvar132 (big blind) showed [Js 4s] and lost with a pair of Aces



PokerStars Game #59915769753:  Hold'em No Limit ($2/$4 USD) - 2011/03/27 18:44:32 ET
Table 'Pulcherrima XI' 2-max Seat #2 is the button
Seat 1: fightingnuns ($485.45 in chips) 
Seat 2: otvar132 ($274.10 in chips) 
otvar132: posts small blind $2
fightingnuns: posts big blind $4
*** HOLE CARDS ***
Dealt to fightingnuns [6s 3d]
otvar132: raises $4 to $8
fightingnuns: folds 
Uncalled bet ($4) returned to otvar132
otvar132 collected $8 from pot
otvar132: doesn't show hand 
*** SUMMARY ***
Total pot $8 | Rake $0 
Seat 1: fightingnuns (big blind) folded before Flop
Seat 2: otvar132 (button) (small blind) collected ($8)



PokerStars Game #59915776869:  Hold'em No Limit ($2/$4 USD) - 2011/03/27 18:44:40 ET
Table 'Pulcherrima XI' 2-max Seat #1 is the button
Seat 1: fightingnuns ($481.45 in chips) 
Seat 2: otvar132 ($278.10 in chips) 
fightingnuns: posts small blind $2
otvar132: posts big blind $4
*** HOLE CARDS ***
Dealt to fightingnuns [3d 8s]
fightingnuns: folds 
Uncalled bet ($2) returned to otvar132
otvar132 collected $4 from pot
otvar132: doesn't show hand 
*** SUMMARY ***
Total pot $4 | Rake $0 
Seat 1: fightingnuns (button) (small blind) folded before Flop
Seat 2: otvar132 (big blind) collected ($4)



PokerStars Game #59915781892:  Hold'em No Limit ($2/$4 USD) - 2011/03/27 18:44:45 ET
Table 'Pulcherrima XI' 2-max Seat #2 is the button
Seat 1: fightingnuns ($479.45 in chips) 
Seat 2: otvar132 ($280.10 in chips) 
otvar132: posts small blind $2
fightingnuns: posts big blind $4
*** HOLE CARDS ***
Dealt to fightingnuns [Ks 8c]
otvar132: raises $4 to $8
fightingnuns: folds 
Uncalled bet ($4) returned to otvar132
otvar132 collected $8 from pot
otvar132: doesn't show hand 
*** SUMMARY ***
Total pot $8 | Rake $0 
Seat 1: fightingnuns (big blind) folded before Flop
Seat 2: otvar132 (button) (small blind) collected ($8)



PokerStars Game #59915789477:  Hold'em No Limit ($2/$4 USD) - 2011/03/27 18:44:53 ET
Table 'Pulcherrima XI' 2-max Seat #1 is the button
Seat 1: fightingnuns ($475.45 in chips) 
Seat 2: otvar132 ($284.10 in chips) 
fightingnuns: posts small blind $2
otvar132: posts big blind $4
*** HOLE CARDS ***
Dealt to fightingnuns [2s Qd]
fightingnuns: folds 
Uncalled bet ($2) returned to otvar132
otvar132 collected $4 from pot
otvar132: doesn't show hand 
*** SUMMARY ***
Total pot $4 | Rake $0 
Seat 1: fightingnuns (button) (small blind) folded before Flop
Seat 2: otvar132 (big blind) collected ($4)



PokerStars Game #59915794614:  Hold'em No Limit ($2/$4 USD) - 2011/03/27 18:44:58 ET
Table 'Pulcherrima XI' 2-max Seat #2 is the button
Seat 1: fightingnuns ($473.45 in chips) 
Seat 2: otvar132 ($286.10 in chips) 
otvar132: posts small blind $2
fightingnuns: posts big blind $4
*** HOLE CARDS ***
Dealt to fightingnuns [Jd 4d]
otvar132: folds 
Uncalled bet ($2) returned to fightingnuns
fightingnuns collected $4 from pot
fightingnuns: doesn't show hand 
*** SUMMARY ***
Total pot $4 | Rake $0 
Seat 1: fightingnuns (big blind) collected ($4)
Seat 2: otvar132 (button) (small blind) folded before Flop



PokerStars Game #59915800438:  Hold'em No Limit ($2/$4 USD) - 2011/03/27 18:45:04 ET
Table 'Pulcherrima XI' 2-max Seat #1 is the button
Seat 1: fightingnuns ($475.45 in chips) 
Seat 2: otvar132 ($284.10 in chips) 
fightingnuns: posts small blind $2
otvar132: posts big blind $4
*** HOLE CARDS ***
Dealt to fightingnuns [3d 4s]
fightingnuns: folds 
Uncalled bet ($2) returned to otvar132
otvar132 collected $4 from pot
*** SUMMARY ***
Total pot $4 | Rake $0 
Seat 1: fightingnuns (button) (small blind) folded before Flop
Seat 2: otvar132 (big blind) collected ($4)



PokerStars Game #59915805561:  Hold'em No Limit ($2/$4 USD) - 2011/03/27 18:45:09 ET
Table 'Pulcherrima XI' 2-max Seat #2 is the button
Seat 1: fightingnuns ($473.45 in chips) 
Seat 2: otvar132 ($286.10 in chips) 
otvar132: posts small blind $2
fightingnuns: posts big blind $4
*** HOLE CARDS ***
Dealt to fightingnuns [5d Kh]
otvar132: calls $2
fightingnuns: checks 
*** FLOP *** [Ks 7h 8d]
fightingnuns: bets $8
otvar132: calls $8
*** TURN *** [Ks 7h 8d] [Tc]
fightingnuns: bets $16
otvar132: calls $16
*** RIVER *** [Ks 7h 8d Tc] [Kc]
fightingnuns: bets $40
otvar132: folds 
Uncalled bet ($40) returned to fightingnuns
fightingnuns collected $55.50 from pot
fightingnuns: doesn't show hand 
*** SUMMARY ***
Total pot $56 | Rake $0.50 
Board [Ks 7h 8d Tc Kc]
Seat 1: fightingnuns (big blind) collected ($55.50)
Seat 2: otvar132 (button) (small blind) folded on the River



PokerStars Game #59915836576:  Hold'em No Limit ($2/$4 USD) - 2011/03/27 18:45:41 ET
Table 'Pulcherrima XI' 2-max Seat #1 is the button
Seat 1: fightingnuns ($500.95 in chips) 
Seat 2: otvar132 ($258.10 in chips) 
fightingnuns: posts small blind $2
otvar132: posts big blind $4
*** HOLE CARDS ***
Dealt to fightingnuns [6s 9d]
fightingnuns: raises $8 to $12
otvar132: calls $8
*** FLOP *** [Tc 2s Ks]
otvar132: checks 
fightingnuns: checks 
*** TURN *** [Tc 2s Ks] [Js]
otvar132: bets $8
fightingnuns: folds 
Uncalled bet ($8) returned to otvar132
otvar132 collected $23.50 from pot
otvar132: doesn't show hand 
*** SUMMARY ***
Total pot $24 | Rake $0.50 
Board [Tc 2s Ks Js]
Seat 1: fightingnuns (button) (small blind) folded on the Turn
Seat 2: otvar132 (big blind) collected ($23.50)



PokerStars Game #59915853275:  Hold'em No Limit ($2/$4 USD) - 2011/03/27 18:45:59 ET
Table 'Pulcherrima XI' 2-max Seat #2 is the button
Seat 1: fightingnuns ($488.95 in chips) 
Seat 2: otvar132 ($269.60 in chips) 
otvar132: posts small blind $2
fightingnuns: posts big blind $4
*** HOLE CARDS ***
Dealt to fightingnuns [8d 2s]
otvar132: folds 
Uncalled bet ($2) returned to fightingnuns
fightingnuns collected $4 from pot
fightingnuns: doesn't show hand 
*** SUMMARY ***
Total pot $4 | Rake $0 
Seat 1: fightingnuns (big blind) collected ($4)
Seat 2: otvar132 (button) (small blind) folded before Flop



PokerStars Game #59915859338:  Hold'em No Limit ($2/$4 USD) - 2011/03/27 18:46:05 ET
Table 'Pulcherrima XI' 2-max Seat #1 is the button
Seat 1: fightingnuns ($490.95 in chips) 
Seat 2: otvar132 ($267.60 in chips) 
fightingnuns: posts small blind $2
otvar132: posts big blind $4
*** HOLE CARDS ***
Dealt to fightingnuns [Tc 9c]
fightingnuns: raises $8 to $12
otvar132: calls $8
*** FLOP *** [3h 5s 6d]
otvar132: bets $12
fightingnuns: folds 
Uncalled bet ($12) returned to otvar132
otvar132 collected $23.50 from pot
otvar132: doesn't show hand 
*** SUMMARY ***
Total pot $24 | Rake $0.50 
Board [3h 5s 6d]
Seat 1: fightingnuns (button) (small blind) folded on the Flop
Seat 2: otvar132 (big blind) collected ($23.50)



PokerStars Game #59915871730:  Hold'em No Limit ($2/$4 USD) - 2011/03/27 18:46:18 ET
Table 'Pulcherrima XI' 2-max Seat #2 is the button
Seat 1: fightingnuns ($478.95 in chips) 
Seat 2: otvar132 ($279.10 in chips) 
otvar132: posts small blind $2
fightingnuns: posts big blind $4
*** HOLE CARDS ***
Dealt to fightingnuns [8h 3h]
otvar132: calls $2
fightingnuns: checks 
*** FLOP *** [9s 7h 9h]
fightingnuns: bets $8
otvar132: calls $8
*** TURN *** [9s 7h 9h] [3s]
fightingnuns: bets $16
otvar132: calls $16
*** RIVER *** [9s 7h 9h 3s] [5d]
fightingnuns: checks 
otvar132: checks 
*** SHOW DOWN ***
fightingnuns: shows [8h 3h] (two pair, Nines and Threes)
otvar132: shows [7d Qd] (two pair, Nines and Sevens)
otvar132 collected $55.50 from pot
*** SUMMARY ***
Total pot $56 | Rake $0.50 
Board [9s 7h 9h 3s 5d]
Seat 1: fightingnuns (big blind) showed [8h 3h] and lost with two pair, Nines and Threes
Seat 2: otvar132 (button) (small blind) showed [7d Qd] and won ($55.50) with two pair, Nines and Sevens



PokerStars Game #59915888821:  Hold'em No Limit ($2/$4 USD) - 2011/03/27 18:46:36 ET
Table 'Pulcherrima XI' 2-max Seat #1 is the button
Seat 1: fightingnuns ($450.95 in chips) 
Seat 2: otvar132 ($306.60 in chips) 
fightingnuns: posts small blind $2
otvar132: posts big blind $4
*** HOLE CARDS ***
Dealt to fightingnuns [7s 9h]
fightingnuns: raises $8 to $12
otvar132: calls $8
*** FLOP *** [8d Ah 9d]
otvar132: checks 
fightingnuns: checks 
*** TURN *** [8d Ah 9d] [8s]
otvar132: checks 
fightingnuns: bets $16
otvar132: folds 
Uncalled bet ($16) returned to fightingnuns
fightingnuns collected $23.50 from pot
fightingnuns: doesn't show hand 
*** SUMMARY ***
Total pot $24 | Rake $0.50 
Board [8d Ah 9d 8s]
Seat 1: fightingnuns (button) (small blind) collected ($23.50)
Seat 2: otvar132 (big blind) folded on the Turn



PokerStars Game #59915906514:  Hold'em No Limit ($2/$4 USD) - 2011/03/27 18:46:55 ET
Table 'Pulcherrima XI' 2-max Seat #2 is the button
Seat 1: fightingnuns ($462.45 in chips) 
Seat 2: otvar132 ($294.60 in chips) 
otvar132: posts small blind $2
fightingnuns: posts big blind $4
*** HOLE CARDS ***
Dealt to fightingnuns [As Qc]
otvar132: calls $2
fightingnuns: raises $20 to $24
otvar132: calls $20
*** FLOP *** [5h Th 8c]
fightingnuns: bets $28
otvar132: folds 
Uncalled bet ($28) returned to fightingnuns
fightingnuns collected $47.50 from pot
fightingnuns: doesn't show hand 
*** SUMMARY ***
Total pot $48 | Rake $0.50 
Board [5h Th 8c]
Seat 1: fightingnuns (big blind) collected ($47.50)
Seat 2: otvar132 (button) (small blind) folded on the Flop



PokerStars Game #59915920476:  Hold'em No Limit ($2/$4 USD) - 2011/03/27 18:47:09 ET
Table 'Pulcherrima XI' 2-max Seat #1 is the button
Seat 1: fightingnuns ($485.95 in chips) 
Seat 2: otvar132 ($270.60 in chips) 
fightingnuns: posts small blind $2
otvar132: posts big blind $4
*** HOLE CARDS ***
Dealt to fightingnuns [Ks Js]
fightingnuns: raises $8 to $12
otvar132: calls $8
*** FLOP *** [4h Qd 5h]
otvar132: checks 
fightingnuns: checks 
*** TURN *** [4h Qd 5h] [Tc]
otvar132: checks 
fightingnuns: bets $16
otvar132: folds 
Uncalled bet ($16) returned to fightingnuns
fightingnuns collected $23.50 from pot
fightingnuns: doesn't show hand 
*** SUMMARY ***
Total pot $24 | Rake $0.50 
Board [4h Qd 5h Tc]
Seat 1: fightingnuns (button) (small blind) collected ($23.50)
Seat 2: otvar132 (big blind) folded on the Turn



PokerStars Game #59915938787:  Hold'em No Limit ($2/$4 USD) - 2011/03/27 18:47:29 ET
Table 'Pulcherrima XI' 2-max Seat #2 is the button
Seat 1: fightingnuns ($497.45 in chips) 
Seat 2: otvar132 ($258.60 in chips) 
otvar132: posts small blind $2
fightingnuns: posts big blind $4
*** HOLE CARDS ***
Dealt to fightingnuns [8c Ts]
otvar132: folds 
Uncalled bet ($2) returned to fightingnuns
fightingnuns collected $4 from pot
fightingnuns: doesn't show hand 
*** SUMMARY ***
Total pot $4 | Rake $0 
Seat 1: fightingnuns (big blind) collected ($4)
Seat 2: otvar132 (button) (small blind) folded before Flop



PokerStars Game #59915944304:  Hold'em No Limit ($2/$4 USD) - 2011/03/27 18:47:34 ET
Table 'Pulcherrima XI' 2-max Seat #1 is the button
Seat 1: fightingnuns ($499.45 in chips) 
Seat 2: otvar132 ($256.60 in chips) 
fightingnuns: posts small blind $2
otvar132: posts big blind $4
*** HOLE CARDS ***
Dealt to fightingnuns [Td Ac]
fightingnuns: raises $8 to $12
otvar132: folds 
Uncalled bet ($8) returned to fightingnuns
fightingnuns collected $8 from pot
fightingnuns: doesn't show hand 
*** SUMMARY ***
Total pot $8 | Rake $0 
Seat 1: fightingnuns (button) (small blind) collected ($8)
Seat 2: otvar132 (big blind) folded before Flop



PokerStars Game #59915952286:  Hold'em No Limit ($2/$4 USD) - 2011/03/27 18:47:43 ET
Table 'Pulcherrima XI' 2-max Seat #2 is the button
Seat 1: fightingnuns ($503.45 in chips) 
Seat 2: otvar132 ($252.60 in chips) 
otvar132: posts small blind $2
fightingnuns: posts big blind $4
*** HOLE CARDS ***
Dealt to fightingnuns [Qc 8d]
otvar132: calls $2
fightingnuns: checks 
*** FLOP *** [6s Jh 8s]
fightingnuns: bets $8
otvar132: calls $8
*** TURN *** [6s Jh 8s] [2d]
fightingnuns: checks 
otvar132: bets $12
fightingnuns: calls $12
*** RIVER *** [6s Jh 8s 2d] [7c]
fightingnuns: checks 
otvar132: bets $16
fightingnuns: calls $16
*** SHOW DOWN ***
otvar132: shows [Js 5c] (a pair of Jacks)
fightingnuns: mucks hand 
otvar132 collected $79.50 from pot
*** SUMMARY ***
Total pot $80 | Rake $0.50 
Board [6s Jh 8s 2d 7c]
Seat 1: fightingnuns (big blind) mucked [Qc 8d]
Seat 2: otvar132 (button) (small blind) showed [Js 5c] and won ($79.50) with a pair of Jacks



PokerStars Game #59915976380:  Hold'em No Limit ($2/$4 USD) - 2011/03/27 18:48:09 ET
Table 'Pulcherrima XI' 2-max Seat #1 is the button
Seat 1: fightingnuns ($463.45 in chips) 
Seat 2: otvar132 ($292.10 in chips) 
fightingnuns: posts small blind $2
otvar132: posts big blind $4
*** HOLE CARDS ***
Dealt to fightingnuns [7h As]
fightingnuns: raises $8 to $12
otvar132: calls $8
*** FLOP *** [9h 8d Js]
otvar132: checks 
fightingnuns: checks 
*** TURN *** [9h 8d Js] [Kh]
otvar132: checks 
fightingnuns: checks 
*** RIVER *** [9h 8d Js Kh] [8h]
otvar132: bets $12
fightingnuns: calls $12
*** SHOW DOWN ***
otvar132: shows [Jd 9c] (two pair, Jacks and Nines)
fightingnuns: mucks hand 
otvar132 collected $47.50 from pot
*** SUMMARY ***
Total pot $48 | Rake $0.50 
Board [9h 8d Js Kh 8h]
Seat 1: fightingnuns (button) (small blind) mucked [7h As]
Seat 2: otvar132 (big blind) showed [Jd 9c] and won ($47.50) with two pair, Jacks and Nines



PokerStars Game #59915999320:  Hold'em No Limit ($2/$4 USD) - 2011/03/27 18:48:33 ET
Table 'Pulcherrima XI' 2-max Seat #2 is the button
Seat 1: fightingnuns ($439.45 in chips) 
Seat 2: otvar132 ($315.60 in chips) 
otvar132: posts small blind $2
fightingnuns: posts big blind $4
*** HOLE CARDS ***
Dealt to fightingnuns [Tc 9d]
otvar132: folds 
Uncalled bet ($2) returned to fightingnuns
fightingnuns collected $4 from pot
fightingnuns: doesn't show hand 
*** SUMMARY ***
Total pot $4 | Rake $0 
Seat 1: fightingnuns (big blind) collected ($4)
Seat 2: otvar132 (button) (small blind) folded before Flop



PokerStars Game #59916005146:  Hold'em No Limit ($2/$4 USD) - 2011/03/27 18:48:39 ET
Table 'Pulcherrima XI' 2-max Seat #1 is the button
Seat 1: fightingnuns ($441.45 in chips) 
Seat 2: otvar132 ($313.60 in chips) 
fightingnuns: posts small blind $2
otvar132: posts big blind $4
*** HOLE CARDS ***
Dealt to fightingnuns [Ah Jh]
fightingnuns: raises $8 to $12
otvar132: calls $8
*** FLOP *** [2s 5s As]
otvar132: bets $12
fightingnuns: raises $24 to $36
otvar132: raises $64 to $100
fightingnuns: folds 
Uncalled bet ($64) returned to otvar132
otvar132 collected $95.50 from pot
otvar132: doesn't show hand 
*** SUMMARY ***
Total pot $96 | Rake $0.50 
Board [2s 5s As]
Seat 1: fightingnuns (button) (small blind) folded on the Flop
Seat 2: otvar132 (big blind) collected ($95.50)



PokerStars Game #59916026104:  Hold'em No Limit ($2/$4 USD) - 2011/03/27 18:49:02 ET
Table 'Pulcherrima XI' 2-max Seat #2 is the button
Seat 1: fightingnuns ($400 in chips) 
Seat 2: otvar132 ($361.10 in chips) 
otvar132: posts small blind $2
fightingnuns: posts big blind $4
*** HOLE CARDS ***
Dealt to fightingnuns [Th 6h]
otvar132: calls $2
fightingnuns: checks 
*** FLOP *** [Qd 7h 2h]
fightingnuns: checks 
otvar132: checks 
*** TURN *** [Qd 7h 2h] [Qc]
fightingnuns: bets $8
otvar132: folds 
Uncalled bet ($8) returned to fightingnuns
fightingnuns collected $7.60 from pot
fightingnuns: doesn't show hand 
*** SUMMARY ***
Total pot $8 | Rake $0.40 
Board [Qd 7h 2h Qc]
Seat 1: fightingnuns (big blind) collected ($7.60)
Seat 2: otvar132 (button) (small blind) folded on the Turn



PokerStars Game #59916039911:  Hold'em No Limit ($2/$4 USD) - 2011/03/27 18:49:17 ET
Table 'Pulcherrima XI' 2-max Seat #1 is the button
Seat 1: fightingnuns ($403.60 in chips) 
Seat 2: otvar132 ($357.10 in chips) 
fightingnuns: posts small blind $2
otvar132: posts big blind $4
*** HOLE CARDS ***
Dealt to fightingnuns [As Kd]
fightingnuns: raises $8 to $12
otvar132: folds 
Uncalled bet ($8) returned to fightingnuns
fightingnuns collected $8 from pot
fightingnuns: doesn't show hand 
*** SUMMARY ***
Total pot $8 | Rake $0 
Seat 1: fightingnuns (button) (small blind) collected ($8)
Seat 2: otvar132 (big blind) folded before Flop



PokerStars Game #59916048234:  Hold'em No Limit ($2/$4 USD) - 2011/03/27 18:49:26 ET
Table 'Pulcherrima XI' 2-max Seat #2 is the button
Seat 1: fightingnuns ($407.60 in chips) 
Seat 2: otvar132 ($353.10 in chips) 
otvar132: posts small blind $2
fightingnuns: posts big blind $4
*** HOLE CARDS ***
Dealt to fightingnuns [4s 5c]
otvar132: calls $2
fightingnuns: checks 
*** FLOP *** [9h Th Js]
fightingnuns: checks 
otvar132: bets $4
fightingnuns: folds 
Uncalled bet ($4) returned to otvar132
otvar132 collected $7.60 from pot
otvar132: doesn't show hand 
*** SUMMARY ***
Total pot $8 | Rake $0.40 
Board [9h Th Js]
Seat 1: fightingnuns (big blind) folded on the Flop
Seat 2: otvar132 (button) (small blind) collected ($7.60)



PokerStars Game #59916058763:  Hold'em No Limit ($2/$4 USD) - 2011/03/27 18:49:37 ET
Table 'Pulcherrima XI' 2-max Seat #1 is the button
Seat 1: fightingnuns ($403.60 in chips) 
Seat 2: otvar132 ($356.70 in chips) 
fightingnuns: posts small blind $2
otvar132: posts big blind $4
*** HOLE CARDS ***
Dealt to fightingnuns [6s 9h]
fightingnuns: raises $8 to $12
otvar132: calls $8
*** FLOP *** [As 2h 3c]
otvar132: bets $8
fightingnuns: folds 
Uncalled bet ($8) returned to otvar132
otvar132 collected $23.50 from pot
otvar132: doesn't show hand 
*** SUMMARY ***
Total pot $24 | Rake $0.50 
Board [As 2h 3c]
Seat 1: fightingnuns (button) (small blind) folded on the Flop
Seat 2: otvar132 (big blind) collected ($23.50)



PokerStars Game #59916070568:  Hold'em No Limit ($2/$4 USD) - 2011/03/27 18:49:50 ET
Table 'Pulcherrima XI' 2-max Seat #2 is the button
Seat 1: fightingnuns ($400 in chips) 
Seat 2: otvar132 ($368.20 in chips) 
otvar132: posts small blind $2
fightingnuns: posts big blind $4
*** HOLE CARDS ***
Dealt to fightingnuns [4d 5s]
otvar132: calls $2
fightingnuns: checks 
*** FLOP *** [4s 7d Ts]
fightingnuns: checks 
otvar132: checks 
*** TURN *** [4s 7d Ts] [Qh]
fightingnuns: checks 
otvar132: bets $12
fightingnuns: folds 
Uncalled bet ($12) returned to otvar132
otvar132 collected $7.60 from pot
otvar132: doesn't show hand 
*** SUMMARY ***
Total pot $8 | Rake $0.40 
Board [4s 7d Ts Qh]
Seat 1: fightingnuns (big blind) folded on the Turn
Seat 2: otvar132 (button) (small blind) collected ($7.60)



PokerStars Game #59916085256:  Hold'em No Limit ($2/$4 USD) - 2011/03/27 18:50:06 ET
Table 'Pulcherrima XI' 2-max Seat #1 is the button
Seat 1: fightingnuns ($400 in chips) 
Seat 2: otvar132 ($371.80 in chips) 
fightingnuns: posts small blind $2
otvar132: posts big blind $4
*** HOLE CARDS ***
Dealt to fightingnuns [Ks Kd]
fightingnuns: raises $8 to $12
otvar132: calls $8
*** FLOP *** [6d 2c 3c]
otvar132: bets $12
fightingnuns: raises $24 to $36
otvar132: calls $24
*** TURN *** [6d 2c 3c] [Qs]
otvar132: checks 
fightingnuns: bets $72
otvar132: calls $72
*** RIVER *** [6d 2c 3c Qs] [Jh]
otvar132: checks 
fightingnuns: bets $178
otvar132: folds 
Uncalled bet ($178) returned to fightingnuns
fightingnuns collected $239.50 from pot
fightingnuns: doesn't show hand 
*** SUMMARY ***
Total pot $240 | Rake $0.50 
Board [6d 2c 3c Qs Jh]
Seat 1: fightingnuns (button) (small blind) collected ($239.50)
Seat 2: otvar132 (big blind) folded on the River



PokerStars Game #59916121418:  Hold'em No Limit ($2/$4 USD) - 2011/03/27 18:50:45 ET
Table 'Pulcherrima XI' 2-max Seat #2 is the button
Seat 1: fightingnuns ($519.50 in chips) 
Seat 2: otvar132 ($251.80 in chips) 
otvar132: posts small blind $2
fightingnuns: posts big blind $4
*** HOLE CARDS ***
Dealt to fightingnuns [7h Jc]
otvar132: calls $2
fightingnuns: checks 
*** FLOP *** [8h Td Jh]
fightingnuns: bets $8
otvar132: calls $8
*** TURN *** [8h Td Jh] [Ad]
fightingnuns: checks 
otvar132: checks 
*** RIVER *** [8h Td Jh Ad] [7d]
fightingnuns: bets $12
otvar132: calls $12
*** SHOW DOWN ***
fightingnuns: shows [7h Jc] (two pair, Jacks and Sevens)
otvar132: mucks hand 
fightingnuns collected $47.50 from pot
*** SUMMARY ***
Total pot $48 | Rake $0.50 
Board [8h Td Jh Ad 7d]
Seat 1: fightingnuns (big blind) showed [7h Jc] and won ($47.50) with two pair, Jacks and Sevens
Seat 2: otvar132 (button) (small blind) mucked [2h 7c]



PokerStars Game #59916141794:  Hold'em No Limit ($2/$4 USD) - 2011/03/27 18:51:07 ET
Table 'Pulcherrima XI' 2-max Seat #1 is the button
Seat 1: fightingnuns ($543 in chips) 
Seat 2: otvar132 ($227.80 in chips) 
fightingnuns: posts small blind $2
otvar132: posts big blind $4
*** HOLE CARDS ***
Dealt to fightingnuns [Qc Kd]
fightingnuns: raises $8 to $12
otvar132: raises $8 to $20
fightingnuns: calls $8
*** FLOP *** [Kc 4c Tc]
otvar132: bets $12
fightingnuns: raises $24 to $36
otvar132: calls $24
*** TURN *** [Kc 4c Tc] [3h]
otvar132: checks 
fightingnuns: bets $60
otvar132: calls $60
*** RIVER *** [Kc 4c Tc 3h] [Ac]
otvar132: checks 
fightingnuns: bets $222
otvar132: folds 
Uncalled bet ($222) returned to fightingnuns
fightingnuns collected $231.50 from pot
fightingnuns: doesn't show hand 
*** SUMMARY ***
Total pot $232 | Rake $0.50 
Board [Kc 4c Tc 3h Ac]
Seat 1: fightingnuns (button) (small blind) collected ($231.50)
Seat 2: otvar132 (big blind) folded on the River



PokerStars Game #59916182642:  Hold'em No Limit ($2/$4 USD) - 2011/03/27 18:51:51 ET
Table 'Pulcherrima XI' 2-max Seat #2 is the button
Seat 1: fightingnuns ($658.50 in chips) 
Seat 2: otvar132 ($111.80 in chips) 
otvar132: posts small blind $2
fightingnuns: posts big blind $4
*** HOLE CARDS ***
Dealt to fightingnuns [5h Kc]
otvar132: raises $107.80 to $111.80 and is all-in
fightingnuns: folds 
Uncalled bet ($107.80) returned to otvar132
otvar132 collected $8 from pot
otvar132: doesn't show hand 
*** SUMMARY ***
Total pot $8 | Rake $0 
Seat 1: fightingnuns (big blind) folded before Flop
Seat 2: otvar132 (button) (small blind) collected ($8)



PokerStars Game #59916190966:  Hold'em No Limit ($2/$4 USD) - 2011/03/27 18:52:00 ET
Table 'Pulcherrima XI' 2-max Seat #1 is the button
Seat 1: fightingnuns ($654.50 in chips) 
Seat 2: otvar132 ($115.80 in chips) 
fightingnuns: posts small blind $2
otvar132: posts big blind $4
*** HOLE CARDS ***
Dealt to fightingnuns [Th 6h]
fightingnuns: raises $4 to $8
otvar132: raises $107.80 to $115.80 and is all-in
fightingnuns: folds 
Uncalled bet ($107.80) returned to otvar132
otvar132 collected $16 from pot
otvar132: doesn't show hand 
*** SUMMARY ***
Total pot $16 | Rake $0 
Seat 1: fightingnuns (button) (small blind) folded before Flop
Seat 2: otvar132 (big blind) collected ($16)



PokerStars Game #59916199248:  Hold'em No Limit ($2/$4 USD) - 2011/03/27 18:52:09 ET
Table 'Pulcherrima XI' 2-max Seat #2 is the button
Seat 1: fightingnuns ($646.50 in chips) 
Seat 2: otvar132 ($123.80 in chips) 
otvar132: posts small blind $2
fightingnuns: posts big blind $4
*** HOLE CARDS ***
Dealt to fightingnuns [Jd 2c]
otvar132: folds 
Uncalled bet ($2) returned to fightingnuns
fightingnuns collected $4 from pot
fightingnuns: doesn't show hand 
*** SUMMARY ***
Total pot $4 | Rake $0 
Seat 1: fightingnuns (big blind) collected ($4)
Seat 2: otvar132 (button) (small blind) folded before Flop



PokerStars Game #59916204866:  Hold'em No Limit ($2/$4 USD) - 2011/03/27 18:52:16 ET
Table 'Pulcherrima XI' 2-max Seat #1 is the button
Seat 1: fightingnuns ($648.50 in chips) 
Seat 2: otvar132 ($121.80 in chips) 
fightingnuns: posts small blind $2
otvar132: posts big blind $4
*** HOLE CARDS ***
Dealt to fightingnuns [Ks Kc]
fightingnuns: raises $4 to $8
otvar132: raises $113.80 to $121.80 and is all-in
fightingnuns: calls $113.80
*** FLOP *** [Jd Kd Js]
*** TURN *** [Jd Kd Js] [6s]
*** RIVER *** [Jd Kd Js 6s] [6d]
*** SHOW DOWN ***
otvar132: shows [Ac Ad] (two pair, Aces and Jacks)
fightingnuns: shows [Ks Kc] (a full house, Kings full of Jacks)
fightingnuns collected $243.10 from pot
*** SUMMARY ***
Total pot $243.60 | Rake $0.50 
Board [Jd Kd Js 6s 6d]
Seat 1: fightingnuns (button) (small blind) showed [Ks Kc] and won ($243.10) with a full house, Kings full of Jacks
Seat 2: otvar132 (big blind) showed [Ac Ad] and lost with two pair, Aces and Jacks



PokerStars Game #59916242101:  Hold'em No Limit ($2/$4 USD) - 2011/03/27 18:52:55 ET
Table 'Pulcherrima XI' 2-max Seat #2 is the button
Seat 1: fightingnuns ($769.80 in chips) 
Seat 2: otvar132 ($400 in chips) 
otvar132: posts small blind $2
fightingnuns: posts big blind $4
*** HOLE CARDS ***
Dealt to fightingnuns [8h 7h]
otvar132: calls $2
fightingnuns: checks 
*** FLOP *** [8d 5h Jh]
fightingnuns: bets $8
otvar132: calls $8
*** TURN *** [8d 5h Jh] [8c]
fightingnuns: bets $28
otvar132: calls $28
*** RIVER *** [8d 5h Jh 8c] [Ks]
fightingnuns: bets $52
otvar132: folds 
Uncalled bet ($52) returned to fightingnuns
fightingnuns collected $79.50 from pot
fightingnuns: doesn't show hand 
*** SUMMARY ***
Total pot $80 | Rake $0.50 
Board [8d 5h Jh 8c Ks]
Seat 1: fightingnuns (big blind) collected ($79.50)
Seat 2: otvar132 (button) (small blind) folded on the River



PokerStars Game #59916271178:  Hold'em No Limit ($2/$4 USD) - 2011/03/27 18:53:27 ET
Table 'Pulcherrima XI' 2-max Seat #1 is the button
Seat 1: fightingnuns ($809.30 in chips) 
Seat 2: otvar132 ($360 in chips) 
fightingnuns: posts small blind $2
otvar132: posts big blind $4
*** HOLE CARDS ***
Dealt to fightingnuns [Ks 4c]
fightingnuns: raises $8 to $12
otvar132: calls $8
*** FLOP *** [8d 2h 3h]
otvar132: bets $12
fightingnuns: folds 
Uncalled bet ($12) returned to otvar132
otvar132 collected $23.50 from pot
otvar132: doesn't show hand 
*** SUMMARY ***
Total pot $24 | Rake $0.50 
Board [8d 2h 3h]
Seat 1: fightingnuns (button) (small blind) folded on the Flop
Seat 2: otvar132 (big blind) collected ($23.50)



PokerStars Game #59916285884:  Hold'em No Limit ($2/$4 USD) - 2011/03/27 18:53:43 ET
Table 'Pulcherrima XI' 2-max Seat #2 is the button
Seat 1: fightingnuns ($797.30 in chips) 
Seat 2: otvar132 ($371.50 in chips) 
otvar132: posts small blind $2
fightingnuns: posts big blind $4
*** HOLE CARDS ***
Dealt to fightingnuns [7h 6d]
otvar132: raises $12 to $16
fightingnuns: folds 
Uncalled bet ($12) returned to otvar132
otvar132 collected $8 from pot
otvar132: doesn't show hand 
*** SUMMARY ***
Total pot $8 | Rake $0 
Seat 1: fightingnuns (big blind) folded before Flop
Seat 2: otvar132 (button) (small blind) collected ($8)



PokerStars Game #59916293299:  Hold'em No Limit ($2/$4 USD) - 2011/03/27 18:53:52 ET
Table 'Pulcherrima XI' 2-max Seat #1 is the button
Seat 1: fightingnuns ($793.30 in chips) 
Seat 2: otvar132 ($375.50 in chips) 
fightingnuns: posts small blind $2
otvar132: posts big blind $4
*** HOLE CARDS ***
Dealt to fightingnuns [6d Td]
fightingnuns: raises $8 to $12
otvar132: calls $8
*** FLOP *** [6c Js 6s]
otvar132: bets $16
fightingnuns: raises $32 to $48
otvar132: raises $52 to $100
fightingnuns: calls $52
*** TURN *** [6c Js 6s] [2h]
otvar132: bets $20
fightingnuns: raises $52 to $72
otvar132: calls $52
*** RIVER *** [6c Js 6s 2h] [4s]
otvar132: checks 
fightingnuns: bets $609.30 and is all-in
otvar132: folds 
Uncalled bet ($609.30) returned to fightingnuns
fightingnuns collected $367.50 from pot
fightingnuns: doesn't show hand 
*** SUMMARY ***
Total pot $368 | Rake $0.50 
Board [6c Js 6s 2h 4s]
Seat 1: fightingnuns (button) (small blind) collected ($367.50)
Seat 2: otvar132 (big blind) folded on the River



PokerStars Game #59916346684:  Hold'em No Limit ($2/$4 USD) - 2011/03/27 18:54:49 ET
Table 'Pulcherrima XI' 2-max Seat #2 is the button
Seat 1: fightingnuns ($976.80 in chips) 
Seat 2: otvar132 ($191.50 in chips) 
otvar132: posts small blind $2
fightingnuns: posts big blind $4
*** HOLE CARDS ***
Dealt to fightingnuns [2c 4d]
otvar132: calls $2
fightingnuns: checks 
*** FLOP *** [6s 5c Ts]
fightingnuns: checks 
otvar132: checks 
*** TURN *** [6s 5c Ts] [5s]
fightingnuns: checks 
otvar132: checks 
*** RIVER *** [6s 5c Ts 5s] [Qh]
fightingnuns: checks 
otvar132: checks 
*** SHOW DOWN ***
fightingnuns: shows [2c 4d] (a pair of Fives)
otvar132: shows [Ad 7d] (a pair of Fives - Ace kicker)
otvar132 collected $7.60 from pot
*** SUMMARY ***
Total pot $8 | Rake $0.40 
Board [6s 5c Ts 5s Qh]
Seat 1: fightingnuns (big blind) showed [2c 4d] and lost with a pair of Fives
Seat 2: otvar132 (button) (small blind) showed [Ad 7d] and won ($7.60) with a pair of Fives



PokerStars Game #59916362900:  Hold'em No Limit ($2/$4 USD) - 2011/03/27 18:55:08 ET
Table 'Pulcherrima XI' 2-max Seat #1 is the button
Seat 1: fightingnuns ($972.80 in chips) 
Seat 2: otvar132 ($195.10 in chips) 
fightingnuns: posts small blind $2
otvar132: posts big blind $4
*** HOLE CARDS ***
Dealt to fightingnuns [8h 4d]
fightingnuns: folds 
Uncalled bet ($2) returned to otvar132
otvar132 collected $4 from pot
otvar132: doesn't show hand 
*** SUMMARY ***
Total pot $4 | Rake $0 
Seat 1: fightingnuns (button) (small blind) folded before Flop
Seat 2: otvar132 (big blind) collected ($4)



PokerStars Game #59916366717:  Hold'em No Limit ($2/$4 USD) - 2011/03/27 18:55:13 ET
Table 'Pulcherrima XI' 2-max Seat #2 is the button
Seat 1: fightingnuns ($970.80 in chips) 
Seat 2: otvar132 ($197.10 in chips) 
otvar132: posts small blind $2
fightingnuns: posts big blind $4
*** HOLE CARDS ***
Dealt to fightingnuns [3d 4s]
otvar132: calls $2
fightingnuns: checks 
*** FLOP *** [7d 8d 2s]
fightingnuns: checks 
otvar132: checks 
*** TURN *** [7d 8d 2s] [2d]
fightingnuns: checks 
otvar132: checks 
*** RIVER *** [7d 8d 2s 2d] [5d]
fightingnuns: bets $8
otvar132: raises $20 to $28
fightingnuns: folds 
Uncalled bet ($20) returned to otvar132
otvar132 collected $23.50 from pot
otvar132: doesn't show hand 
*** SUMMARY ***
Total pot $24 | Rake $0.50 
Board [7d 8d 2s 2d 5d]
Seat 1: fightingnuns (big blind) folded on the River
Seat 2: otvar132 (button) (small blind) collected ($23.50)



PokerStars Game #59916378925:  Hold'em No Limit ($2/$4 USD) - 2011/03/27 18:55:32 ET
Table 'Pulcherrima XI' 2-max Seat #1 is the button
Seat 1: fightingnuns ($958.80 in chips) 
Seat 2: otvar132 ($208.60 in chips) 
fightingnuns: posts small blind $2
otvar132: posts big blind $4
*** HOLE CARDS ***
Dealt to fightingnuns [6d 6c]
fightingnuns: raises $8 to $12
otvar132: folds 
Uncalled bet ($8) returned to fightingnuns
fightingnuns collected $8 from pot
fightingnuns: doesn't show hand 
*** SUMMARY ***
Total pot $8 | Rake $0 
Seat 1: fightingnuns (button) (small blind) collected ($8)
Seat 2: otvar132 (big blind) folded before Flop



PokerStars Game #59916383282:  Hold'em No Limit ($2/$4 USD) - 2011/03/27 18:55:38 ET
Table 'Pulcherrima XI' 2-max Seat #2 is the button
Seat 1: fightingnuns ($962.80 in chips) 
Seat 2: otvar132 ($204.60 in chips) 
otvar132: posts small blind $2
fightingnuns: posts big blind $4
*** HOLE CARDS ***
Dealt to fightingnuns [Ah 3s]
otvar132: calls $2
fightingnuns: checks 
*** FLOP *** [5h 9h 3c]
fightingnuns: checks 
otvar132: checks 
*** TURN *** [5h 9h 3c] [4d]
fightingnuns: checks 
otvar132: checks 
*** RIVER *** [5h 9h 3c 4d] [Qs]
fightingnuns: checks 
otvar132: checks 
*** SHOW DOWN ***
fightingnuns: shows [Ah 3s] (a pair of Threes)
otvar132: mucks hand 
fightingnuns collected $7.60 from pot
*** SUMMARY ***
Total pot $8 | Rake $0.40 
Board [5h 9h 3c 4d Qs]
Seat 1: fightingnuns (big blind) showed [Ah 3s] and won ($7.60) with a pair of Threes
Seat 2: otvar132 (button) (small blind) mucked [As 6c]



PokerStars Game #59916395754:  Hold'em No Limit ($2/$4 USD) - 2011/03/27 18:55:57 ET
Table 'Pulcherrima XI' 2-max Seat #1 is the button
Seat 1: fightingnuns ($966.40 in chips) 
Seat 2: otvar132 ($200.60 in chips) 
fightingnuns: posts small blind $2
otvar132: posts big blind $4
*** HOLE CARDS ***
Dealt to fightingnuns [Ad 5d]
fightingnuns: raises $8 to $12
otvar132: calls $8
*** FLOP *** [Tc Qs 8s]
otvar132: checks 
fightingnuns: checks 
*** TURN *** [Tc Qs 8s] [9c]
otvar132: checks 
fightingnuns: bets $16
otvar132: calls $16
*** RIVER *** [Tc Qs 8s 9c] [9d]
otvar132: checks 
fightingnuns: checks 
*** SHOW DOWN ***
otvar132: shows [3h 6c] (a pair of Nines)
fightingnuns: shows [Ad 5d] (a pair of Nines - Ace kicker)
fightingnuns collected $55.50 from pot
*** SUMMARY ***
Total pot $56 | Rake $0.50 
Board [Tc Qs 8s 9c 9d]
Seat 1: fightingnuns (button) (small blind) showed [Ad 5d] and won ($55.50) with a pair of Nines
Seat 2: otvar132 (big blind) showed [3h 6c] and lost with a pair of Nines



PokerStars Game #59916410796:  Hold'em No Limit ($2/$4 USD) - 2011/03/27 18:56:20 ET
Table 'Pulcherrima XI' 2-max Seat #2 is the button
Seat 1: fightingnuns ($993.90 in chips) 
Seat 2: otvar132 ($172.60 in chips) 
otvar132: posts small blind $2
fightingnuns: posts big blind $4
*** HOLE CARDS ***
Dealt to fightingnuns [4d Qd]
otvar132: calls $2
fightingnuns: checks 
*** FLOP *** [6s 4s Ac]
fightingnuns: checks 
otvar132: checks 
*** TURN *** [6s 4s Ac] [Ad]
fightingnuns: checks 
otvar132: checks 
*** RIVER *** [6s 4s Ac Ad] [9c]
fightingnuns: checks 
otvar132: bets $8
fightingnuns: folds 
Uncalled bet ($8) returned to otvar132
otvar132 collected $7.60 from pot
otvar132: doesn't show hand 
*** SUMMARY ***
Total pot $8 | Rake $0.40 
Board [6s 4s Ac Ad 9c]
Seat 1: fightingnuns (big blind) folded on the River
Seat 2: otvar132 (button) (small blind) collected ($7.60)



PokerStars Game #59916422310:  Hold'em No Limit ($2/$4 USD) - 2011/03/27 18:56:38 ET
Table 'Pulcherrima XI' 2-max Seat #1 is the button
Seat 1: fightingnuns ($989.90 in chips) 
Seat 2: otvar132 ($176.20 in chips) 
fightingnuns: posts small blind $2
otvar132: posts big blind $4
*** HOLE CARDS ***
Dealt to fightingnuns [Tc Ah]
fightingnuns: raises $8 to $12
otvar132: raises $8 to $20
fightingnuns: calls $8
*** FLOP *** [7h 4h Kh]
otvar132: bets $16
fightingnuns: calls $16
*** TURN *** [7h 4h Kh] [Kc]
otvar132: checks 
fightingnuns: checks 
*** RIVER *** [7h 4h Kh Kc] [2h]
otvar132: checks 
fightingnuns: bets $52
otvar132: folds 
Uncalled bet ($52) returned to fightingnuns
fightingnuns collected $71.50 from pot
fightingnuns: doesn't show hand 
*** SUMMARY ***
Total pot $72 | Rake $0.50 
Board [7h 4h Kh Kc 2h]
Seat 1: fightingnuns (button) (small blind) collected ($71.50)
Seat 2: otvar132 (big blind) folded on the River



PokerStars Game #59916444127:  Hold'em No Limit ($2/$4 USD) - 2011/03/27 18:57:11 ET
Table 'Pulcherrima XI' 2-max Seat #2 is the button
Seat 1: fightingnuns ($1025.40 in chips) 
Seat 2: otvar132 ($140.20 in chips) 
otvar132: posts small blind $2
fightingnuns: posts big blind $4
*** HOLE CARDS ***
Dealt to fightingnuns [As Js]
otvar132: calls $2
fightingnuns: raises $12 to $16
otvar132: calls $12
*** FLOP *** [Ts 8s 5h]
fightingnuns: bets $24
otvar132: folds 
Uncalled bet ($24) returned to fightingnuns
fightingnuns collected $31.50 from pot
fightingnuns: doesn't show hand 
*** SUMMARY ***
Total pot $32 | Rake $0.50 
Board [Ts 8s 5h]
Seat 1: fightingnuns (big blind) collected ($31.50)
Seat 2: otvar132 (button) (small blind) folded on the Flop



PokerStars Game #59916463829:  Hold'em No Limit ($2/$4 USD) - 2011/03/27 18:57:41 ET
Table 'Pulcherrima XI' 2-max Seat #1 is the button
Seat 1: fightingnuns ($1040.90 in chips) 
Seat 2: otvar132 ($124.20 in chips) 
fightingnuns: posts small blind $2
otvar132: posts big blind $4
*** HOLE CARDS ***
Dealt to fightingnuns [Kd 8c]
fightingnuns: raises $4 to $8
otvar132: raises $16 to $24
fightingnuns: calls $16
*** FLOP *** [Ks 8s 2c]
otvar132: bets $20
fightingnuns: raises $32 to $52
otvar132: raises $48.20 to $100.20 and is all-in
fightingnuns: calls $48.20
*** TURN *** [Ks 8s 2c] [4h]
*** RIVER *** [Ks 8s 2c 4h] [Qh]
*** SHOW DOWN ***
otvar132: shows [3c Kh] (a pair of Kings)
fightingnuns: shows [Kd 8c] (two pair, Kings and Eights)
fightingnuns collected $247.90 from pot
*** SUMMARY ***
Total pot $248.40 | Rake $0.50 
Board [Ks 8s 2c 4h Qh]
Seat 1: fightingnuns (button) (small blind) showed [Kd 8c] and won ($247.90) with two pair, Kings and Eights
Seat 2: otvar132 (big blind) showed [3c Kh] and lost with a pair of Kings



PokerStars Game #59916498482:  Hold'em No Limit ($2/$4 USD) - 2011/03/27 18:58:34 ET
Table 'Pulcherrima XI' 2-max Seat #2 is the button
Seat 1: fightingnuns ($1164.60 in chips) 
Seat 2: otvar132 ($178.35 in chips) 
otvar132: posts small blind $2
fightingnuns: posts big blind $4
*** HOLE CARDS ***
Dealt to fightingnuns [Kh 4h]
otvar132: raises $4 to $8
fightingnuns: calls $4
*** FLOP *** [9s Ad Js]
fightingnuns: checks 
otvar132: bets $12
fightingnuns: folds 
Uncalled bet ($12) returned to otvar132
otvar132 collected $15.50 from pot
otvar132: doesn't show hand 
*** SUMMARY ***
Total pot $16 | Rake $0.50 
Board [9s Ad Js]
Seat 1: fightingnuns (big blind) folded on the Flop
Seat 2: otvar132 (button) (small blind) collected ($15.50)



PokerStars Game #59916507553:  Hold'em No Limit ($2/$4 USD) - 2011/03/27 18:58:47 ET
Table 'Pulcherrima XI' 2-max Seat #1 is the button
Seat 1: fightingnuns ($1156.60 in chips) 
Seat 2: otvar132 ($185.85 in chips) 
fightingnuns: posts small blind $2
otvar132: posts big blind $4
*** HOLE CARDS ***
Dealt to fightingnuns [Th Qc]
fightingnuns: raises $8 to $12
otvar132: folds 
Uncalled bet ($8) returned to fightingnuns
fightingnuns collected $8 from pot
fightingnuns: doesn't show hand 
*** SUMMARY ***
Total pot $8 | Rake $0 
Seat 1: fightingnuns (button) (small blind) collected ($8)
Seat 2: otvar132 (big blind) folded before Flop



PokerStars Game #59916512154:  Hold'em No Limit ($2/$4 USD) - 2011/03/27 18:58:54 ET
Table 'Pulcherrima XI' 2-max Seat #2 is the button
Seat 1: fightingnuns ($1160.60 in chips) 
Seat 2: otvar132 ($181.85 in chips) 
otvar132: posts small blind $2
fightingnuns: posts big blind $4
*** HOLE CARDS ***
Dealt to fightingnuns [Js 3s]
otvar132: raises $8 to $12
fightingnuns: folds 
Uncalled bet ($8) returned to otvar132
otvar132 collected $8 from pot
otvar132: doesn't show hand 
*** SUMMARY ***
Total pot $8 | Rake $0 
Seat 1: fightingnuns (big blind) folded before Flop
Seat 2: otvar132 (button) (small blind) collected ($8)



PokerStars Game #59916517244:  Hold'em No Limit ($2/$4 USD) - 2011/03/27 18:59:02 ET
Table 'Pulcherrima XI' 2-max Seat #1 is the button
Seat 1: fightingnuns ($1156.60 in chips) 
Seat 2: otvar132 ($185.85 in chips) 
fightingnuns: posts small blind $2
otvar132: posts big blind $4
*** HOLE CARDS ***
Dealt to fightingnuns [9s 4d]
fightingnuns: folds 
Uncalled bet ($2) returned to otvar132
otvar132 collected $4 from pot
otvar132: doesn't show hand 
*** SUMMARY ***
Total pot $4 | Rake $0 
Seat 1: fightingnuns (button) (small blind) folded before Flop
Seat 2: otvar132 (big blind) collected ($4)



PokerStars Game #59916520727:  Hold'em No Limit ($2/$4 USD) - 2011/03/27 18:59:07 ET
Table 'Pulcherrima XI' 2-max Seat #2 is the button
Seat 1: fightingnuns ($1154.60 in chips) 
Seat 2: otvar132 ($187.85 in chips) 
otvar132: posts small blind $2
fightingnuns: posts big blind $4
*** HOLE CARDS ***
Dealt to fightingnuns [Qs As]
otvar132: calls $2
fightingnuns: raises $12 to $16
otvar132: folds 
Uncalled bet ($12) returned to fightingnuns
fightingnuns collected $8 from pot
fightingnuns: doesn't show hand 
*** SUMMARY ***
Total pot $8 | Rake $0 
Seat 1: fightingnuns (big blind) collected ($8)
Seat 2: otvar132 (button) (small blind) folded before Flop



PokerStars Game #59916529502:  Hold'em No Limit ($2/$4 USD) - 2011/03/27 18:59:21 ET
Table 'Pulcherrima XI' 2-max Seat #1 is the button
Seat 1: fightingnuns ($1158.60 in chips) 
Seat 2: otvar132 ($183.85 in chips) 
fightingnuns: posts small blind $2
otvar132: posts big blind $4
*** HOLE CARDS ***
Dealt to fightingnuns [Jd 2h]
fightingnuns: folds 
Uncalled bet ($2) returned to otvar132
otvar132 collected $4 from pot
otvar132: doesn't show hand 
*** SUMMARY ***
Total pot $4 | Rake $0 
Seat 1: fightingnuns (button) (small blind) folded before Flop
Seat 2: otvar132 (big blind) collected ($4)



PokerStars Game #59916534308:  Hold'em No Limit ($2/$4 USD) - 2011/03/27 18:59:28 ET
Table 'Pulcherrima XI' 2-max Seat #2 is the button
Seat 1: fightingnuns ($1156.60 in chips) 
Seat 2: otvar132 ($185.85 in chips) 
otvar132: posts small blind $2
fightingnuns: posts big blind $4
*** HOLE CARDS ***
Dealt to fightingnuns [8c 5d]
otvar132: calls $2
fightingnuns: checks 
*** FLOP *** [3d Jc 4c]
fightingnuns: checks 
otvar132: checks 
*** TURN *** [3d Jc 4c] [As]
fightingnuns: checks 
otvar132: checks 
*** RIVER *** [3d Jc 4c As] [5c]
fightingnuns: checks 
otvar132: checks 
*** SHOW DOWN ***
fightingnuns: shows [8c 5d] (a pair of Fives)
otvar132: mucks hand 
fightingnuns collected $7.60 from pot
*** SUMMARY ***
Total pot $8 | Rake $0.40 
Board [3d Jc 4c As 5c]
Seat 1: fightingnuns (big blind) showed [8c 5d] and won ($7.60) with a pair of Fives
Seat 2: otvar132 (button) (small blind) mucked [7s Qd]



PokerStars Game #59916548135:  Hold'em No Limit ($2/$4 USD) - 2011/03/27 18:59:49 ET
Table 'Pulcherrima XI' 2-max Seat #1 is the button
Seat 1: fightingnuns ($1160.20 in chips) 
Seat 2: otvar132 ($181.85 in chips) 
fightingnuns: posts small blind $2
otvar132: posts big blind $4
*** HOLE CARDS ***
Dealt to fightingnuns [2c Qd]
fightingnuns: folds 
Uncalled bet ($2) returned to otvar132
otvar132 collected $4 from pot
otvar132: doesn't show hand 
*** SUMMARY ***
Total pot $4 | Rake $0 
Seat 1: fightingnuns (button) (small blind) folded before Flop
Seat 2: otvar132 (big blind) collected ($4)



PokerStars Game #59916552805:  Hold'em No Limit ($2/$4 USD) - 2011/03/27 18:59:56 ET
Table 'Pulcherrima XI' 2-max Seat #2 is the button
Seat 1: fightingnuns ($1158.20 in chips) 
Seat 2: otvar132 ($183.85 in chips) 
otvar132: posts small blind $2
fightingnuns: posts big blind $4
*** HOLE CARDS ***
Dealt to fightingnuns [2c 4d]
otvar132: calls $2
fightingnuns: checks 
*** FLOP *** [Ts Td Kc]
fightingnuns: checks 
otvar132: checks 
*** TURN *** [Ts Td Kc] [6c]
fightingnuns: bets $8
otvar132: folds 
Uncalled bet ($8) returned to fightingnuns
fightingnuns collected $7.60 from pot
fightingnuns: doesn't show hand 
*** SUMMARY ***
Total pot $8 | Rake $0.40 
Board [Ts Td Kc 6c]
Seat 1: fightingnuns (big blind) collected ($7.60)
Seat 2: otvar132 (button) (small blind) folded on the Turn



PokerStars Game #59916567592:  Hold'em No Limit ($2/$4 USD) - 2011/03/27 19:00:13 ET
Table 'Pulcherrima XI' 2-max Seat #1 is the button
Seat 1: fightingnuns ($1161.80 in chips) 
Seat 2: otvar132 ($179.85 in chips) 
fightingnuns: posts small blind $2
otvar132: posts big blind $4
*** HOLE CARDS ***
Dealt to fightingnuns [7s 3c]
fightingnuns: folds 
Uncalled bet ($2) returned to otvar132
otvar132 collected $4 from pot
otvar132: doesn't show hand 
*** SUMMARY ***
Total pot $4 | Rake $0 
Seat 1: fightingnuns (button) (small blind) folded before Flop
Seat 2: otvar132 (big blind) collected ($4)



PokerStars Game #59916571647:  Hold'em No Limit ($2/$4 USD) - 2011/03/27 19:00:19 ET
Table 'Pulcherrima XI' 2-max Seat #2 is the button
Seat 1: fightingnuns ($1159.80 in chips) 
Seat 2: otvar132 ($181.85 in chips) 
otvar132: posts small blind $2
fightingnuns: posts big blind $4
*** HOLE CARDS ***
Dealt to fightingnuns [8d Ks]
otvar132: calls $2
fightingnuns: checks 
*** FLOP *** [6d Ad 5s]
fightingnuns: checks 
otvar132: bets $8
fightingnuns: folds 
Uncalled bet ($8) returned to otvar132
otvar132 collected $7.60 from pot
*** SUMMARY ***
Total pot $8 | Rake $0.40 
Board [6d Ad 5s]
Seat 1: fightingnuns (big blind) folded on the Flop
Seat 2: otvar132 (button) (small blind) collected ($7.60)



PokerStars Game #59916580428:  Hold'em No Limit ($2/$4 USD) - 2011/03/27 19:00:32 ET
Table 'Pulcherrima XI' 2-max Seat #1 is the button
Seat 1: fightingnuns ($1155.80 in chips) 
Seat 2: otvar132 ($185.45 in chips) 
fightingnuns: posts small blind $2
otvar132: posts big blind $4
*** HOLE CARDS ***
Dealt to fightingnuns [Tc Jh]
fightingnuns: raises $8 to $12
otvar132: calls $8
*** FLOP *** [8h Td Js]
otvar132: bets $16
fightingnuns: raises $36 to $52
otvar132: raises $48 to $100
fightingnuns: raises $592 to $692
otvar132: calls $73.45 and is all-in
Uncalled bet ($518.55) returned to fightingnuns
*** TURN *** [8h Td Js] [5s]
*** RIVER *** [8h Td Js 5s] [2s]
*** SHOW DOWN ***
otvar132: shows [Qd 9c] (a straight, Eight to Queen)
fightingnuns: shows [Tc Jh] (two pair, Jacks and Tens)
otvar132 collected $370.40 from pot
*** SUMMARY ***
Total pot $370.90 | Rake $0.50 
Board [8h Td Js 5s 2s]
Seat 1: fightingnuns (button) (small blind) showed [Tc Jh] and lost with two pair, Jacks and Tens
Seat 2: otvar132 (big blind) showed [Qd 9c] and won ($370.40) with a straight, Eight to Queen



PokerStars Game #59916609143:  Hold'em No Limit ($2/$4 USD) - 2011/03/27 19:01:11 ET
Table 'Pulcherrima XI' 2-max Seat #2 is the button
Seat 1: fightingnuns ($970.35 in chips) 
Seat 2: otvar132 ($370.40 in chips) 
otvar132: posts small blind $2
fightingnuns: posts big blind $4
*** HOLE CARDS ***
Dealt to fightingnuns [Td 3c]
otvar132: folds 
Uncalled bet ($2) returned to fightingnuns
fightingnuns collected $4 from pot
fightingnuns: doesn't show hand 
*** SUMMARY ***
Total pot $4 | Rake $0 
Seat 1: fightingnuns (big blind) collected ($4)
Seat 2: otvar132 (button) (small blind) folded before Flop



PokerStars Game #59916616029:  Hold'em No Limit ($2/$4 USD) - 2011/03/27 19:01:20 ET
Table 'Pulcherrima XI' 2-max Seat #1 is the button
Seat 1: fightingnuns ($972.35 in chips) 
Seat 2: otvar132 ($368.40 in chips) 
fightingnuns: posts small blind $2
otvar132: posts big blind $4
*** HOLE CARDS ***
Dealt to fightingnuns [9s 5c]
fightingnuns: folds 
Uncalled bet ($2) returned to otvar132
otvar132 collected $4 from pot
otvar132: doesn't show hand 
*** SUMMARY ***
Total pot $4 | Rake $0 
Seat 1: fightingnuns (button) (small blind) folded before Flop
Seat 2: otvar132 (big blind) collected ($4)



PokerStars Game #59916620807:  Hold'em No Limit ($2/$4 USD) - 2011/03/27 19:01:26 ET
Table 'Pulcherrima XI' 2-max Seat #2 is the button
Seat 1: fightingnuns ($970.35 in chips) 
Seat 2: otvar132 ($370.40 in chips) 
otvar132: posts small blind $2
fightingnuns: posts big blind $4
*** HOLE CARDS ***
Dealt to fightingnuns [6h 5h]
otvar132: folds 
Uncalled bet ($2) returned to fightingnuns
fightingnuns collected $4 from pot
fightingnuns: doesn't show hand 
*** SUMMARY ***
Total pot $4 | Rake $0 
Seat 1: fightingnuns (big blind) collected ($4)
Seat 2: otvar132 (button) (small blind) folded before Flop



PokerStars Game #59916626233:  Hold'em No Limit ($2/$4 USD) - 2011/03/27 19:01:32 ET
Table 'Pulcherrima XI' 2-max Seat #1 is the button
Seat 1: fightingnuns ($972.35 in chips) 
Seat 2: otvar132 ($368.40 in chips) 
fightingnuns: posts small blind $2
otvar132: posts big blind $4
*** HOLE CARDS ***
Dealt to fightingnuns [Kh 9s]
fightingnuns: raises $8 to $12
otvar132: calls $8
*** FLOP *** [2c 3d 4s]
otvar132: checks 
fightingnuns: checks 
*** TURN *** [2c 3d 4s] [7c]
otvar132: checks 
fightingnuns: checks 
*** RIVER *** [2c 3d 4s 7c] [5s]
otvar132: bets $12
fightingnuns: folds 
Uncalled bet ($12) returned to otvar132
otvar132 collected $23.50 from pot
otvar132: doesn't show hand 
*** SUMMARY ***
Total pot $24 | Rake $0.50 
Board [2c 3d 4s 7c 5s]
Seat 1: fightingnuns (button) (small blind) folded on the River
Seat 2: otvar132 (big blind) collected ($23.50)



PokerStars Game #59916645123:  Hold'em No Limit ($2/$4 USD) - 2011/03/27 19:01:55 ET
Table 'Pulcherrima XI' 2-max Seat #2 is the button
Seat 1: fightingnuns ($960.35 in chips) 
Seat 2: otvar132 ($379.90 in chips) 
otvar132: posts small blind $2
fightingnuns: posts big blind $4
*** HOLE CARDS ***
Dealt to fightingnuns [9c 3s]
otvar132: raises $12 to $16
fightingnuns: folds 
Uncalled bet ($12) returned to otvar132
otvar132 collected $8 from pot
*** SUMMARY ***
Total pot $8 | Rake $0 
Seat 1: fightingnuns (big blind) folded before Flop
Seat 2: otvar132 (button) (small blind) collected ($8)



PokerStars Game #59916652350:  Hold'em No Limit ($2/$4 USD) - 2011/03/27 19:02:02 ET
Table 'Pulcherrima XI' 2-max Seat #1 is the button
Seat 1: fightingnuns ($956.35 in chips) 
Seat 2: otvar132 ($383.90 in chips) 
fightingnuns: posts small blind $2
otvar132: posts big blind $4
*** HOLE CARDS ***
Dealt to fightingnuns [Tc Qh]
fightingnuns: raises $8 to $12
otvar132: calls $8
*** FLOP *** [Kh 7s 6d]
otvar132: checks 
fightingnuns: checks 
*** TURN *** [Kh 7s 6d] [Ad]
otvar132: checks 
fightingnuns: bets $16
otvar132: calls $16
*** RIVER *** [Kh 7s 6d Ad] [3c]
otvar132: checks 
fightingnuns: checks 
*** SHOW DOWN ***
otvar132: shows [7h 9d] (a pair of Sevens)
fightingnuns: mucks hand 
otvar132 collected $55.50 from pot
*** SUMMARY ***
Total pot $56 | Rake $0.50 
Board [Kh 7s 6d Ad 3c]
Seat 1: fightingnuns (button) (small blind) mucked [Tc Qh]
Seat 2: otvar132 (big blind) showed [7h 9d] and won ($55.50) with a pair of Sevens



PokerStars Game #59916671630:  Hold'em No Limit ($2/$4 USD) - 2011/03/27 19:02:24 ET
Table 'Pulcherrima XI' 2-max Seat #2 is the button
Seat 1: fightingnuns ($928.35 in chips) 
Seat 2: otvar132 ($411.40 in chips) 
otvar132: posts small blind $2
fightingnuns: posts big blind $4
*** HOLE CARDS ***
Dealt to fightingnuns [Kd 3s]
otvar132: raises $8 to $12
fightingnuns: folds 
Uncalled bet ($8) returned to otvar132
otvar132 collected $8 from pot
otvar132: doesn't show hand 
*** SUMMARY ***
Total pot $8 | Rake $0 
Seat 1: fightingnuns (big blind) folded before Flop
Seat 2: otvar132 (button) (small blind) collected ($8)



PokerStars Game #59916677978:  Hold'em No Limit ($2/$4 USD) - 2011/03/27 19:02:32 ET
Table 'Pulcherrima XI' 2-max Seat #1 is the button
Seat 1: fightingnuns ($924.35 in chips) 
Seat 2: otvar132 ($415.40 in chips) 
fightingnuns: posts small blind $2
otvar132: posts big blind $4
*** HOLE CARDS ***
Dealt to fightingnuns [3d 6s]
fightingnuns: folds 
Uncalled bet ($2) returned to otvar132
otvar132 collected $4 from pot
otvar132: doesn't show hand 
*** SUMMARY ***
Total pot $4 | Rake $0 
Seat 1: fightingnuns (button) (small blind) folded before Flop
Seat 2: otvar132 (big blind) collected ($4)



PokerStars Game #59916682580:  Hold'em No Limit ($2/$4 USD) - 2011/03/27 19:02:37 ET
Table 'Pulcherrima XI' 2-max Seat #2 is the button
Seat 1: fightingnuns ($922.35 in chips) 
Seat 2: otvar132 ($417.40 in chips) 
otvar132: posts small blind $2
fightingnuns: posts big blind $4
*** HOLE CARDS ***
Dealt to fightingnuns [5h 3s]
otvar132: calls $2
fightingnuns: checks 
*** FLOP *** [9h 2c Ah]
fightingnuns: checks 
otvar132: checks 
*** TURN *** [9h 2c Ah] [Jc]
fightingnuns: checks 
otvar132: checks 
*** RIVER *** [9h 2c Ah Jc] [7s]
fightingnuns: checks 
otvar132: bets $4
fightingnuns: folds 
Uncalled bet ($4) returned to otvar132
otvar132 collected $7.60 from pot
otvar132: doesn't show hand 
*** SUMMARY ***
Total pot $8 | Rake $0.40 
Board [9h 2c Ah Jc 7s]
Seat 1: fightingnuns (big blind) folded on the River
Seat 2: otvar132 (button) (small blind) collected ($7.60)



PokerStars Game #59916698477:  Hold'em No Limit ($2/$4 USD) - 2011/03/27 19:02:55 ET
Table 'Pulcherrima XI' 2-max Seat #1 is the button
Seat 1: fightingnuns ($918.35 in chips) 
Seat 2: otvar132 ($421 in chips) 
fightingnuns: posts small blind $2
otvar132: posts big blind $4
*** HOLE CARDS ***
Dealt to fightingnuns [Qc Th]
fightingnuns: raises $8 to $12
otvar132: raises $8 to $20
fightingnuns: calls $8
*** FLOP *** [Qd 3c 5d]
otvar132: checks 
fightingnuns: bets $24
otvar132: calls $24
*** TURN *** [Qd 3c 5d] [8d]
otvar132: checks 
fightingnuns: bets $56
otvar132: calls $56
*** RIVER *** [Qd 3c 5d 8d] [6s]
otvar132: bets $24
fightingnuns: raises $84 to $108
otvar132: calls $84
*** SHOW DOWN ***
fightingnuns: shows [Qc Th] (a pair of Queens)
otvar132: mucks hand 
fightingnuns collected $415.50 from pot
*** SUMMARY ***
Total pot $416 | Rake $0.50 
Board [Qd 3c 5d 8d 6s]
Seat 1: fightingnuns (button) (small blind) showed [Qc Th] and won ($415.50) with a pair of Queens
Seat 2: otvar132 (big blind) mucked [Ts Td]



PokerStars Game #59916744367:  Hold'em No Limit ($2/$4 USD) - 2011/03/27 19:03:45 ET
Table 'Pulcherrima XI' 2-max Seat #2 is the button
Seat 1: fightingnuns ($1125.85 in chips) 
Seat 2: otvar132 ($213 in chips) 
otvar132: posts small blind $2
fightingnuns: posts big blind $4
*** HOLE CARDS ***
Dealt to fightingnuns [As Td]
otvar132: raises $4 to $8
fightingnuns: calls $4
*** FLOP *** [6d Ah Qd]
fightingnuns: checks 
otvar132: checks 
*** TURN *** [6d Ah Qd] [7h]
fightingnuns: bets $24
otvar132: folds 
Uncalled bet ($24) returned to fightingnuns
fightingnuns collected $15.50 from pot
fightingnuns: doesn't show hand 
*** SUMMARY ***
Total pot $16 | Rake $0.50 
Board [6d Ah Qd 7h]
Seat 1: fightingnuns (big blind) collected ($15.50)
Seat 2: otvar132 (button) (small blind) folded on the Turn



PokerStars Game #59916761160:  Hold'em No Limit ($2/$4 USD) - 2011/03/27 19:04:02 ET
Table 'Pulcherrima XI' 2-max Seat #1 is the button
Seat 1: fightingnuns ($1133.35 in chips) 
Seat 2: otvar132 ($205 in chips) 
fightingnuns: posts small blind $2
otvar132: posts big blind $4
*** HOLE CARDS ***
Dealt to fightingnuns [3s Kh]
fightingnuns: raises $8 to $12
otvar132: calls $8
*** FLOP *** [Qs Ad Qd]
otvar132: checks 
fightingnuns: checks 
*** TURN *** [Qs Ad Qd] [8h]
otvar132: bets $4
fightingnuns: calls $4
*** RIVER *** [Qs Ad Qd 8h] [Tc]
otvar132: bets $4
fightingnuns: calls $4
*** SHOW DOWN ***
otvar132: shows [3d Jh] (a pair of Queens)
fightingnuns: shows [3s Kh] (a pair of Queens - Ace+King kicker)
fightingnuns collected $39.50 from pot
*** SUMMARY ***
Total pot $40 | Rake $0.50 
Board [Qs Ad Qd 8h Tc]
Seat 1: fightingnuns (button) (small blind) showed [3s Kh] and won ($39.50) with a pair of Queens
Seat 2: otvar132 (big blind) showed [3d Jh] and lost with a pair of Queens



PokerStars Game #59916780902:  Hold'em No Limit ($2/$4 USD) - 2011/03/27 19:04:24 ET
Table 'Pulcherrima XI' 2-max Seat #2 is the button
Seat 1: fightingnuns ($1152.85 in chips) 
Seat 2: otvar132 ($185 in chips) 
otvar132: posts small blind $2
fightingnuns: posts big blind $4
*** HOLE CARDS ***
Dealt to fightingnuns [6h Kd]
otvar132: raises $8 to $12
fightingnuns: folds 
Uncalled bet ($8) returned to otvar132
otvar132 collected $8 from pot
otvar132: doesn't show hand 
*** SUMMARY ***
Total pot $8 | Rake $0 
Seat 1: fightingnuns (big blind) folded before Flop
Seat 2: otvar132 (button) (small blind) collected ($8)



PokerStars Game #59916787805:  Hold'em No Limit ($2/$4 USD) - 2011/03/27 19:04:32 ET
Table 'Pulcherrima XI' 2-max Seat #1 is the button
Seat 1: fightingnuns ($1148.85 in chips) 
Seat 2: otvar132 ($189 in chips) 
fightingnuns: posts small blind $2
otvar132: posts big blind $4
*** HOLE CARDS ***
Dealt to fightingnuns [9h 2d]
fightingnuns: folds 
Uncalled bet ($2) returned to otvar132
otvar132 collected $4 from pot
otvar132: doesn't show hand 
*** SUMMARY ***
Total pot $4 | Rake $0 
Seat 1: fightingnuns (button) (small blind) folded before Flop
Seat 2: otvar132 (big blind) collected ($4)



PokerStars Game #59916792599:  Hold'em No Limit ($2/$4 USD) - 2011/03/27 19:04:37 ET
Table 'Pulcherrima XI' 2-max Seat #2 is the button
Seat 1: fightingnuns ($1146.85 in chips) 
Seat 2: otvar132 ($191 in chips) 
otvar132: posts small blind $2
fightingnuns: posts big blind $4
*** HOLE CARDS ***
Dealt to fightingnuns [7h Qd]
otvar132: folds 
Uncalled bet ($2) returned to fightingnuns
fightingnuns collected $4 from pot
fightingnuns: doesn't show hand 
*** SUMMARY ***
Total pot $4 | Rake $0 
Seat 1: fightingnuns (big blind) collected ($4)
Seat 2: otvar132 (button) (small blind) folded before Flop



PokerStars Game #59916797929:  Hold'em No Limit ($2/$4 USD) - 2011/03/27 19:04:43 ET
Table 'Pulcherrima XI' 2-max Seat #1 is the button
Seat 1: fightingnuns ($1148.85 in chips) 
Seat 2: otvar132 ($189 in chips) 
fightingnuns: posts small blind $2
otvar132: posts big blind $4
*** HOLE CARDS ***
Dealt to fightingnuns [Kc Jc]
fightingnuns: raises $8 to $12
otvar132: calls $8
*** FLOP *** [8s 6s Ks]
otvar132: checks 
fightingnuns: bets $24
otvar132: folds 
Uncalled bet ($24) returned to fightingnuns
fightingnuns collected $23.50 from pot
fightingnuns: doesn't show hand 
*** SUMMARY ***
Total pot $24 | Rake $0.50 
Board [8s 6s Ks]
Seat 1: fightingnuns (button) (small blind) collected ($23.50)
Seat 2: otvar132 (big blind) folded on the Flop



PokerStars Game #59916812036:  Hold'em No Limit ($2/$4 USD) - 2011/03/27 19:04:58 ET
Table 'Pulcherrima XI' 2-max Seat #2 is the button
Seat 1: fightingnuns ($1160.35 in chips) 
Seat 2: otvar132 ($177 in chips) 
otvar132: posts small blind $2
fightingnuns: posts big blind $4
*** HOLE CARDS ***
Dealt to fightingnuns [Ah 9d]
otvar132: folds 
Uncalled bet ($2) returned to fightingnuns
fightingnuns collected $4 from pot
fightingnuns: doesn't show hand 
*** SUMMARY ***
Total pot $4 | Rake $0 
Seat 1: fightingnuns (big blind) collected ($4)
Seat 2: otvar132 (button) (small blind) folded before Flop



PokerStars Game #59916817773:  Hold'em No Limit ($2/$4 USD) - 2011/03/27 19:05:04 ET
Table 'Pulcherrima XI' 2-max Seat #1 is the button
Seat 1: fightingnuns ($1162.35 in chips) 
Seat 2: otvar132 ($175 in chips) 
fightingnuns: posts small blind $2
otvar132: posts big blind $4
*** HOLE CARDS ***
Dealt to fightingnuns [3d Kd]
fightingnuns: raises $8 to $12
otvar132: calls $8
*** FLOP *** [7c Ad 6c]
otvar132: checks 
fightingnuns: checks 
*** TURN *** [7c Ad 6c] [Kh]
otvar132: checks 
fightingnuns: bets $16
otvar132: calls $16
*** RIVER *** [7c Ad 6c Kh] [2h]
otvar132: bets $16
fightingnuns: calls $16
*** SHOW DOWN ***
otvar132: shows [3c 7d] (a pair of Sevens)
fightingnuns: shows [3d Kd] (a pair of Kings)
fightingnuns collected $87.50 from pot
*** SUMMARY ***
Total pot $88 | Rake $0.50 
Board [7c Ad 6c Kh 2h]
Seat 1: fightingnuns (button) (small blind) showed [3d Kd] and won ($87.50) with a pair of Kings
Seat 2: otvar132 (big blind) showed [3c 7d] and lost with a pair of Sevens



PokerStars Game #59916839887:  Hold'em No Limit ($2/$4 USD) - 2011/03/27 19:05:28 ET
Table 'Pulcherrima XI' 2-max Seat #2 is the button
Seat 1: fightingnuns ($1205.85 in chips) 
Seat 2: otvar132 ($131 in chips) 
otvar132: posts small blind $2
fightingnuns: posts big blind $4
*** HOLE CARDS ***
Dealt to fightingnuns [5d 8h]
otvar132: raises $8 to $12
fightingnuns: folds 
Uncalled bet ($8) returned to otvar132
otvar132 collected $8 from pot
otvar132: doesn't show hand 
*** SUMMARY ***
Total pot $8 | Rake $0 
Seat 1: fightingnuns (big blind) folded before Flop
Seat 2: otvar132 (button) (small blind) collected ($8)



PokerStars Game #59916847192:  Hold'em No Limit ($2/$4 USD) - 2011/03/27 19:05:35 ET
Table 'Pulcherrima XI' 2-max Seat #1 is the button
Seat 1: fightingnuns ($1201.85 in chips) 
Seat 2: otvar132 ($135 in chips) 
fightingnuns: posts small blind $2
otvar132: posts big blind $4
*** HOLE CARDS ***
Dealt to fightingnuns [Jc Tc]
fightingnuns: raises $8 to $12
otvar132: calls $8
*** FLOP *** [8s Qc 6d]
otvar132: checks 
fightingnuns: checks 
*** TURN *** [8s Qc 6d] [4c]
otvar132: checks 
fightingnuns: bets $16
otvar132: raises $107 to $123 and is all-in
fightingnuns: folds 
Uncalled bet ($107) returned to otvar132
otvar132 collected $55.50 from pot
otvar132: doesn't show hand 
*** SUMMARY ***
Total pot $56 | Rake $0.50 
Board [8s Qc 6d 4c]
Seat 1: fightingnuns (button) (small blind) folded on the Turn
Seat 2: otvar132 (big blind) collected ($55.50)



PokerStars Game #59916870371:  Hold'em No Limit ($2/$4 USD) - 2011/03/27 19:06:00 ET
Table 'Pulcherrima XI' 2-max Seat #2 is the button
Seat 1: fightingnuns ($1173.85 in chips) 
Seat 2: otvar132 ($162.50 in chips) 
otvar132: posts small blind $2
fightingnuns: posts big blind $4
*** HOLE CARDS ***
Dealt to fightingnuns [Ts Js]
otvar132: folds 
Uncalled bet ($2) returned to fightingnuns
fightingnuns collected $4 from pot
fightingnuns: doesn't show hand 
*** SUMMARY ***
Total pot $4 | Rake $0 
Seat 1: fightingnuns (big blind) collected ($4)
Seat 2: otvar132 (button) (small blind) folded before Flop



PokerStars Game #59916876359:  Hold'em No Limit ($2/$4 USD) - 2011/03/27 19:06:06 ET
Table 'Pulcherrima XI' 2-max Seat #1 is the button
Seat 1: fightingnuns ($1175.85 in chips) 
Seat 2: otvar132 ($160.50 in chips) 
fightingnuns: posts small blind $2
otvar132: posts big blind $4
*** HOLE CARDS ***
Dealt to fightingnuns [4s 7h]
fightingnuns: folds 
Uncalled bet ($2) returned to otvar132
otvar132 collected $4 from pot
otvar132: doesn't show hand 
*** SUMMARY ***
Total pot $4 | Rake $0 
Seat 1: fightingnuns (button) (small blind) folded before Flop
Seat 2: otvar132 (big blind) collected ($4)



PokerStars Game #59916881346:  Hold'em No Limit ($2/$4 USD) - 2011/03/27 19:06:12 ET
Table 'Pulcherrima XI' 2-max Seat #2 is the button
Seat 1: fightingnuns ($1173.85 in chips) 
Seat 2: otvar132 ($162.50 in chips) 
otvar132: posts small blind $2
fightingnuns: posts big blind $4
*** HOLE CARDS ***
Dealt to fightingnuns [Tc Td]
otvar132: calls $2
fightingnuns: raises $20 to $24
otvar132: calls $20
*** FLOP *** [Qh Ad 6c]
fightingnuns: checks 
otvar132: bets $20
fightingnuns: folds 
Uncalled bet ($20) returned to otvar132
otvar132 collected $47.50 from pot
otvar132: doesn't show hand 
*** SUMMARY ***
Total pot $48 | Rake $0.50 
Board [Qh Ad 6c]
Seat 1: fightingnuns (big blind) folded on the Flop
Seat 2: otvar132 (button) (small blind) collected ($47.50)



PokerStars Game #59916899279:  Hold'em No Limit ($2/$4 USD) - 2011/03/27 19:06:32 ET
Table 'Pulcherrima XI' 2-max Seat #1 is the button
Seat 1: fightingnuns ($1149.85 in chips) 
Seat 2: otvar132 ($186 in chips) 
fightingnuns: posts small blind $2
otvar132: posts big blind $4
*** HOLE CARDS ***
Dealt to fightingnuns [Td 6d]
fightingnuns: raises $8 to $12
otvar132: folds 
Uncalled bet ($8) returned to fightingnuns
fightingnuns collected $8 from pot
fightingnuns: doesn't show hand 
*** SUMMARY ***
Total pot $8 | Rake $0 
Seat 1: fightingnuns (button) (small blind) collected ($8)
Seat 2: otvar132 (big blind) folded before Flop



PokerStars Game #59916906147:  Hold'em No Limit ($2/$4 USD) - 2011/03/27 19:06:38 ET
Table 'Pulcherrima XI' 2-max Seat #2 is the button
Seat 1: fightingnuns ($1153.85 in chips) 
Seat 2: otvar132 ($182 in chips) 
otvar132: posts small blind $2
fightingnuns: posts big blind $4
*** HOLE CARDS ***
Dealt to fightingnuns [4s 9c]
otvar132: calls $2
fightingnuns: checks 
*** FLOP *** [As Kd 4c]
fightingnuns: checks 
otvar132: checks 
*** TURN *** [As Kd 4c] [Jc]
fightingnuns: checks 
otvar132: checks 
*** RIVER *** [As Kd 4c Jc] [4d]
fightingnuns: bets $16
otvar132: folds 
Uncalled bet ($16) returned to fightingnuns
fightingnuns collected $7.60 from pot
fightingnuns: doesn't show hand 
*** SUMMARY ***
Total pot $8 | Rake $0.40 
Board [As Kd 4c Jc 4d]
Seat 1: fightingnuns (big blind) collected ($7.60)
Seat 2: otvar132 (button) (small blind) folded on the River



PokerStars Game #59916921208:  Hold'em No Limit ($2/$4 USD) - 2011/03/27 19:06:55 ET
Table 'Pulcherrima XI' 2-max Seat #1 is the button
Seat 1: fightingnuns ($1157.45 in chips) 
Seat 2: otvar132 ($178 in chips) 
fightingnuns: posts small blind $2
otvar132: posts big blind $4
*** HOLE CARDS ***
Dealt to fightingnuns [5c Jc]
fightingnuns: raises $8 to $12
otvar132: calls $8
*** FLOP *** [7h 9s 7c]
otvar132: checks 
fightingnuns: bets $16
otvar132: calls $16
*** TURN *** [7h 9s 7c] [4d]
otvar132: checks 
fightingnuns: checks 
*** RIVER *** [7h 9s 7c 4d] [7s]
otvar132: bets $150 and is all-in
fightingnuns: folds 
Uncalled bet ($150) returned to otvar132
otvar132 collected $55.50 from pot
otvar132: doesn't show hand 
*** SUMMARY ***
Total pot $56 | Rake $0.50 
Board [7h 9s 7c 4d 7s]
Seat 1: fightingnuns (button) (small blind) folded on the River
Seat 2: otvar132 (big blind) collected ($55.50)



PokerStars Game #59916949736:  Hold'em No Limit ($2/$4 USD) - 2011/03/27 19:07:25 ET
Table 'Pulcherrima XI' 2-max Seat #2 is the button
Seat 1: fightingnuns ($1129.45 in chips) 
Seat 2: otvar132 ($205.50 in chips) 
otvar132: posts small blind $2
fightingnuns: posts big blind $4
*** HOLE CARDS ***
Dealt to fightingnuns [Kc 2c]
otvar132: calls $2
fightingnuns: checks 
*** FLOP *** [Jh Qh 7s]
fightingnuns: checks 
otvar132: checks 
*** TURN *** [Jh Qh 7s] [3h]
fightingnuns: checks 
otvar132: bets $4
fightingnuns: folds 
Uncalled bet ($4) returned to otvar132
otvar132 collected $7.60 from pot
otvar132: doesn't show hand 
*** SUMMARY ***
Total pot $8 | Rake $0.40 
Board [Jh Qh 7s 3h]
Seat 1: fightingnuns (big blind) folded on the Turn
Seat 2: otvar132 (button) (small blind) collected ($7.60)



PokerStars Game #59916965992:  Hold'em No Limit ($2/$4 USD) - 2011/03/27 19:07:43 ET
Table 'Pulcherrima XI' 2-max Seat #1 is the button
Seat 1: fightingnuns ($1125.45 in chips) 
Seat 2: otvar132 ($209.10 in chips) 
fightingnuns: posts small blind $2
otvar132: posts big blind $4
*** HOLE CARDS ***
Dealt to fightingnuns [2s Ks]
fightingnuns: raises $8 to $12
otvar132: raises $8 to $20
fightingnuns: calls $8
*** FLOP *** [7s 7d Td]
otvar132: bets $12
fightingnuns: folds 
Uncalled bet ($12) returned to otvar132
otvar132 collected $39.50 from pot
otvar132: doesn't show hand 
*** SUMMARY ***
Total pot $40 | Rake $0.50 
Board [7s 7d Td]
Seat 1: fightingnuns (button) (small blind) folded on the Flop
Seat 2: otvar132 (big blind) collected ($39.50)



PokerStars Game #59916979600:  Hold'em No Limit ($2/$4 USD) - 2011/03/27 19:07:57 ET
Table 'Pulcherrima XI' 2-max Seat #2 is the button
Seat 1: fightingnuns ($1105.45 in chips) 
Seat 2: otvar132 ($228.60 in chips) 
otvar132: posts small blind $2
fightingnuns: posts big blind $4
*** HOLE CARDS ***
Dealt to fightingnuns [Ah Kc]
otvar132: calls $2
fightingnuns: raises $20 to $24
otvar132: calls $20
*** FLOP *** [Kd Ad 7c]
fightingnuns: bets $36
otvar132: folds 
Uncalled bet ($36) returned to fightingnuns
fightingnuns collected $47.50 from pot
fightingnuns: doesn't show hand 
*** SUMMARY ***
Total pot $48 | Rake $0.50 
Board [Kd Ad 7c]
Seat 1: fightingnuns (big blind) collected ($47.50)
Seat 2: otvar132 (button) (small blind) folded on the Flop



PokerStars Game #59916994297:  Hold'em No Limit ($2/$4 USD) - 2011/03/27 19:08:13 ET
Table 'Pulcherrima XI' 2-max Seat #1 is the button
Seat 1: fightingnuns ($1128.95 in chips) 
Seat 2: otvar132 ($204.60 in chips) 
fightingnuns: posts small blind $2
otvar132: posts big blind $4
*** HOLE CARDS ***
Dealt to fightingnuns [7c 9h]
fightingnuns: raises $8 to $12
otvar132: raises $8 to $20
fightingnuns: calls $8
*** FLOP *** [Kh 4s 6c]
otvar132: bets $16
fightingnuns: folds 
Uncalled bet ($16) returned to otvar132
otvar132 collected $39.50 from pot
otvar132: doesn't show hand 
*** SUMMARY ***
Total pot $40 | Rake $0.50 
Board [Kh 4s 6c]
Seat 1: fightingnuns (button) (small blind) folded on the Flop
Seat 2: otvar132 (big blind) collected ($39.50)



PokerStars Game #59917008076:  Hold'em No Limit ($2/$4 USD) - 2011/03/27 19:08:28 ET
Table 'Pulcherrima XI' 2-max Seat #2 is the button
Seat 1: fightingnuns ($1108.95 in chips) 
Seat 2: otvar132 ($224.10 in chips) 
otvar132: posts small blind $2
fightingnuns: posts big blind $4
*** HOLE CARDS ***
Dealt to fightingnuns [3c 6h]
otvar132: calls $2
fightingnuns: checks 
*** FLOP *** [Kh 3h Jc]
fightingnuns: checks 
otvar132: checks 
*** TURN *** [Kh 3h Jc] [8s]
fightingnuns: checks 
otvar132: checks 
*** RIVER *** [Kh 3h Jc 8s] [9h]
fightingnuns: checks 
otvar132: checks 
*** SHOW DOWN ***
fightingnuns: shows [3c 6h] (a pair of Threes)
otvar132: mucks hand 
fightingnuns collected $7.60 from pot
*** SUMMARY ***
Total pot $8 | Rake $0.40 
Board [Kh 3h Jc 8s 9h]
Seat 1: fightingnuns (big blind) showed [3c 6h] and won ($7.60) with a pair of Threes
Seat 2: otvar132 (button) (small blind) mucked [7d Qh]



PokerStars Game #59917023867:  Hold'em No Limit ($2/$4 USD) - 2011/03/27 19:08:45 ET
Table 'Pulcherrima XI' 2-max Seat #1 is the button
Seat 1: fightingnuns ($1112.55 in chips) 
Seat 2: otvar132 ($220.10 in chips) 
fightingnuns: posts small blind $2
otvar132: posts big blind $4
*** HOLE CARDS ***
Dealt to fightingnuns [6d 4c]
fightingnuns: folds 
Uncalled bet ($2) returned to otvar132
otvar132 collected $4 from pot
otvar132: doesn't show hand 
*** SUMMARY ***
Total pot $4 | Rake $0 
Seat 1: fightingnuns (button) (small blind) folded before Flop
Seat 2: otvar132 (big blind) collected ($4)



PokerStars Game #59917028568:  Hold'em No Limit ($2/$4 USD) - 2011/03/27 19:08:50 ET
Table 'Pulcherrima XI' 2-max Seat #2 is the button
Seat 1: fightingnuns ($1110.55 in chips) 
Seat 2: otvar132 ($222.10 in chips) 
otvar132: posts small blind $2
fightingnuns: posts big blind $4
*** HOLE CARDS ***
Dealt to fightingnuns [4d Ks]
otvar132: raises $4 to $8
fightingnuns: folds 
Uncalled bet ($4) returned to otvar132
otvar132 collected $8 from pot
otvar132: doesn't show hand 
*** SUMMARY ***
Total pot $8 | Rake $0 
Seat 1: fightingnuns (big blind) folded before Flop
Seat 2: otvar132 (button) (small blind) collected ($8)



PokerStars Game #59917034986:  Hold'em No Limit ($2/$4 USD) - 2011/03/27 19:08:57 ET
Table 'Pulcherrima XI' 2-max Seat #1 is the button
Seat 1: fightingnuns ($1106.55 in chips) 
Seat 2: otvar132 ($226.10 in chips) 
fightingnuns: posts small blind $2
otvar132: posts big blind $4
*** HOLE CARDS ***
Dealt to fightingnuns [Ah 6c]
fightingnuns: raises $8 to $12
otvar132: calls $8
*** FLOP *** [Jd Tc 6d]
otvar132: checks 
fightingnuns: checks 
*** TURN *** [Jd Tc 6d] [7d]
otvar132: checks 
fightingnuns: checks 
*** RIVER *** [Jd Tc 6d 7d] [2s]
otvar132: bets $20
fightingnuns: folds 
Uncalled bet ($20) returned to otvar132
otvar132 collected $23.50 from pot
otvar132: doesn't show hand 
*** SUMMARY ***
Total pot $24 | Rake $0.50 
Board [Jd Tc 6d 7d 2s]
Seat 1: fightingnuns (button) (small blind) folded on the River
Seat 2: otvar132 (big blind) collected ($23.50)



PokerStars Game #59917053533:  Hold'em No Limit ($2/$4 USD) - 2011/03/27 19:09:17 ET
Table 'Pulcherrima XI' 2-max Seat #2 is the button
Seat 1: fightingnuns ($1094.55 in chips) 
Seat 2: otvar132 ($237.60 in chips) 
otvar132: posts small blind $2
fightingnuns: posts big blind $4
*** HOLE CARDS ***
Dealt to fightingnuns [Js Ks]
otvar132: folds 
Uncalled bet ($2) returned to fightingnuns
fightingnuns collected $4 from pot
fightingnuns: doesn't show hand 
*** SUMMARY ***
Total pot $4 | Rake $0 
Seat 1: fightingnuns (big blind) collected ($4)
Seat 2: otvar132 (button) (small blind) folded before Flop



PokerStars Game #59917058715:  Hold'em No Limit ($2/$4 USD) - 2011/03/27 19:09:23 ET
Table 'Pulcherrima XI' 2-max Seat #1 is the button
Seat 1: fightingnuns ($1096.55 in chips) 
Seat 2: otvar132 ($235.60 in chips) 
fightingnuns: posts small blind $2
otvar132: posts big blind $4
*** HOLE CARDS ***
Dealt to fightingnuns [2s 4s]
fightingnuns: raises $8 to $12
otvar132: calls $8
*** FLOP *** [Ts Kh 4d]
otvar132: checks 
fightingnuns: checks 
*** TURN *** [Ts Kh 4d] [4c]
otvar132: checks 
fightingnuns: bets $16
otvar132: folds 
Uncalled bet ($16) returned to fightingnuns
fightingnuns collected $23.50 from pot
fightingnuns: doesn't show hand 
*** SUMMARY ***
Total pot $24 | Rake $0.50 
Board [Ts Kh 4d 4c]
Seat 1: fightingnuns (button) (small blind) collected ($23.50)
Seat 2: otvar132 (big blind) folded on the Turn



PokerStars Game #59917074577:  Hold'em No Limit ($2/$4 USD) - 2011/03/27 19:09:41 ET
Table 'Pulcherrima XI' 2-max Seat #2 is the button
Seat 1: fightingnuns ($1108.05 in chips) 
Seat 2: otvar132 ($223.60 in chips) 
otvar132: posts small blind $2
fightingnuns: posts big blind $4
*** HOLE CARDS ***
Dealt to fightingnuns [Kh Td]
otvar132: calls $2
fightingnuns: raises $16 to $20
otvar132: calls $16
*** FLOP *** [Js Jc 2c]
fightingnuns: bets $28
otvar132: folds 
Uncalled bet ($28) returned to fightingnuns
fightingnuns collected $39.50 from pot
fightingnuns: doesn't show hand 
*** SUMMARY ***
Total pot $40 | Rake $0.50 
Board [Js Jc 2c]
Seat 1: fightingnuns (big blind) collected ($39.50)
Seat 2: otvar132 (button) (small blind) folded on the Flop



PokerStars Game #59917088995:  Hold'em No Limit ($2/$4 USD) - 2011/03/27 19:09:57 ET
Table 'Pulcherrima XI' 2-max Seat #1 is the button
Seat 1: fightingnuns ($1127.55 in chips) 
Seat 2: otvar132 ($203.60 in chips) 
fightingnuns: posts small blind $2
otvar132: posts big blind $4
*** HOLE CARDS ***
Dealt to fightingnuns [Qd Kd]
fightingnuns: raises $8 to $12
otvar132: folds 
Uncalled bet ($8) returned to fightingnuns
fightingnuns collected $8 from pot
fightingnuns: doesn't show hand 
*** SUMMARY ***
Total pot $8 | Rake $0 
Seat 1: fightingnuns (button) (small blind) collected ($8)
Seat 2: otvar132 (big blind) folded before Flop



PokerStars Game #59917095137:  Hold'em No Limit ($2/$4 USD) - 2011/03/27 19:10:03 ET
Table 'Pulcherrima XI' 2-max Seat #2 is the button
Seat 1: fightingnuns ($1131.55 in chips) 
Seat 2: otvar132 ($199.60 in chips) 
otvar132: posts small blind $2
fightingnuns: posts big blind $4
*** HOLE CARDS ***
Dealt to fightingnuns [Qd 5c]
otvar132: calls $2
fightingnuns: checks 
*** FLOP *** [3h Ah 2h]
fightingnuns: checks 
otvar132: checks 
*** TURN *** [3h Ah 2h] [Qc]
fightingnuns: checks 
otvar132: checks 
*** RIVER *** [3h Ah 2h Qc] [8h]
fightingnuns: checks 
otvar132: checks 
*** SHOW DOWN ***
fightingnuns: shows [Qd 5c] (a pair of Queens)
otvar132: mucks hand 
fightingnuns collected $7.60 from pot
*** SUMMARY ***
Total pot $8 | Rake $0.40 
Board [3h Ah 2h Qc 8h]
Seat 1: fightingnuns (big blind) showed [Qd 5c] and won ($7.60) with a pair of Queens
Seat 2: otvar132 (button) (small blind) mucked [3d 4d]



PokerStars Game #59917111340:  Hold'em No Limit ($2/$4 USD) - 2011/03/27 19:10:21 ET
Table 'Pulcherrima XI' 2-max Seat #1 is the button
Seat 1: fightingnuns ($1135.15 in chips) 
Seat 2: otvar132 ($195.60 in chips) 
fightingnuns: posts small blind $2
otvar132: posts big blind $4
*** HOLE CARDS ***
Dealt to fightingnuns [Td 4c]
fightingnuns: folds 
Uncalled bet ($2) returned to otvar132
otvar132 collected $4 from pot
otvar132: doesn't show hand 
*** SUMMARY ***
Total pot $4 | Rake $0 
Seat 1: fightingnuns (button) (small blind) folded before Flop
Seat 2: otvar132 (big blind) collected ($4)



PokerStars Game #59917115987:  Hold'em No Limit ($2/$4 USD) - 2011/03/27 19:10:26 ET
Table 'Pulcherrima XI' 2-max Seat #2 is the button
Seat 1: fightingnuns ($1133.15 in chips) 
Seat 2: otvar132 ($197.60 in chips) 
otvar132: posts small blind $2
fightingnuns: posts big blind $4
*** HOLE CARDS ***
Dealt to fightingnuns [7h 4h]
otvar132: calls $2
fightingnuns: checks 
*** FLOP *** [8c 6d 4c]
fightingnuns: checks 
otvar132: bets $8
fightingnuns: calls $8
*** TURN *** [8c 6d 4c] [5c]
fightingnuns: bets $24
otvar132: calls $24
*** RIVER *** [8c 6d 4c 5c] [As]
fightingnuns: bets $44
otvar132: folds 
Uncalled bet ($44) returned to fightingnuns
fightingnuns collected $71.50 from pot
fightingnuns: doesn't show hand 
*** SUMMARY ***
Total pot $72 | Rake $0.50 
Board [8c 6d 4c 5c As]
Seat 1: fightingnuns (big blind) collected ($71.50)
Seat 2: otvar132 (button) (small blind) folded on the River



PokerStars Game #59917139035:  Hold'em No Limit ($2/$4 USD) - 2011/03/27 19:10:51 ET
Table 'Pulcherrima XI' 2-max Seat #1 is the button
Seat 1: fightingnuns ($1168.65 in chips) 
Seat 2: otvar132 ($161.60 in chips) 
fightingnuns: posts small blind $2
otvar132: posts big blind $4
*** HOLE CARDS ***
Dealt to fightingnuns [8s 4c]
fightingnuns: folds 
Uncalled bet ($2) returned to otvar132
otvar132 collected $4 from pot
otvar132: doesn't show hand 
*** SUMMARY ***
Total pot $4 | Rake $0 
Seat 1: fightingnuns (button) (small blind) folded before Flop
Seat 2: otvar132 (big blind) collected ($4)



PokerStars Game #59917143945:  Hold'em No Limit ($2/$4 USD) - 2011/03/27 19:10:57 ET
Table 'Pulcherrima XI' 2-max Seat #2 is the button
Seat 1: fightingnuns ($1166.65 in chips) 
Seat 2: otvar132 ($163.60 in chips) 
otvar132: posts small blind $2
fightingnuns: posts big blind $4
*** HOLE CARDS ***
Dealt to fightingnuns [Ac Th]
otvar132: calls $2
fightingnuns: raises $16 to $20
otvar132: raises $64 to $84
fightingnuns: folds 
Uncalled bet ($64) returned to otvar132
otvar132 collected $40 from pot
otvar132: doesn't show hand 
*** SUMMARY ***
Total pot $40 | Rake $0 
Seat 1: fightingnuns (big blind) folded before Flop
Seat 2: otvar132 (button) (small blind) collected ($40)



PokerStars Game #59917157846:  Hold'em No Limit ($2/$4 USD) - 2011/03/27 19:11:12 ET
Table 'Pulcherrima XI' 2-max Seat #1 is the button
Seat 1: fightingnuns ($1146.65 in chips) 
Seat 2: otvar132 ($183.60 in chips) 
fightingnuns: posts small blind $2
otvar132: posts big blind $4
*** HOLE CARDS ***
Dealt to fightingnuns [Jh Ac]
fightingnuns: raises $8 to $12
otvar132: raises $40 to $52
fightingnuns: folds 
Uncalled bet ($40) returned to otvar132
otvar132 collected $24 from pot
otvar132: doesn't show hand 
*** SUMMARY ***
Total pot $24 | Rake $0 
Seat 1: fightingnuns (button) (small blind) folded before Flop
Seat 2: otvar132 (big blind) collected ($24)



PokerStars Game #59917167787:  Hold'em No Limit ($2/$4 USD) - 2011/03/27 19:11:23 ET
Table 'Pulcherrima XI' 2-max Seat #2 is the button
Seat 1: fightingnuns ($1134.65 in chips) 
Seat 2: otvar132 ($195.60 in chips) 
otvar132: posts small blind $2
fightingnuns: posts big blind $4
*** HOLE CARDS ***
Dealt to fightingnuns [Ad Tc]
otvar132: calls $2
fightingnuns: raises $16 to $20
otvar132: calls $16
*** FLOP *** [Ah Ts 8d]
fightingnuns: bets $28
otvar132: folds 
Uncalled bet ($28) returned to fightingnuns
fightingnuns collected $39.50 from pot
fightingnuns: doesn't show hand 
*** SUMMARY ***
Total pot $40 | Rake $0.50 
Board [Ah Ts 8d]
Seat 1: fightingnuns (big blind) collected ($39.50)
Seat 2: otvar132 (button) (small blind) folded on the Flop



PokerStars Game #59917181174:  Hold'em No Limit ($2/$4 USD) - 2011/03/27 19:11:39 ET
Table 'Pulcherrima XI' 2-max Seat #1 is the button
Seat 1: fightingnuns ($1154.15 in chips) 
Seat 2: otvar132 ($175.60 in chips) 
fightingnuns: posts small blind $2
otvar132: posts big blind $4
*** HOLE CARDS ***
Dealt to fightingnuns [7h Ad]
fightingnuns: raises $8 to $12
otvar132: calls $8
*** FLOP *** [Qh 7s 9s]
otvar132: bets $16
fightingnuns: folds 
Uncalled bet ($16) returned to otvar132
otvar132 collected $23.50 from pot
otvar132: doesn't show hand 
*** SUMMARY ***
Total pot $24 | Rake $0.50 
Board [Qh 7s 9s]
Seat 1: fightingnuns (button) (small blind) folded on the Flop
Seat 2: otvar132 (big blind) collected ($23.50)



PokerStars Game #59917193912:  Hold'em No Limit ($2/$4 USD) - 2011/03/27 19:11:52 ET
Table 'Pulcherrima XI' 2-max Seat #2 is the button
Seat 1: fightingnuns ($1142.15 in chips) 
Seat 2: otvar132 ($187.10 in chips) 
otvar132: posts small blind $2
fightingnuns: posts big blind $4
*** HOLE CARDS ***
Dealt to fightingnuns [As Js]
otvar132: calls $2
fightingnuns: raises $16 to $20
otvar132: calls $16
*** FLOP *** [Kh 5h 5c]
fightingnuns: bets $28
otvar132: folds 
Uncalled bet ($28) returned to fightingnuns
fightingnuns collected $39.50 from pot
fightingnuns: doesn't show hand 
*** SUMMARY ***
Total pot $40 | Rake $0.50 
Board [Kh 5h 5c]
Seat 1: fightingnuns (big blind) collected ($39.50)
Seat 2: otvar132 (button) (small blind) folded on the Flop



PokerStars Game #59917209448:  Hold'em No Limit ($2/$4 USD) - 2011/03/27 19:12:09 ET
Table 'Pulcherrima XI' 2-max Seat #1 is the button
Seat 1: fightingnuns ($1161.65 in chips) 
Seat 2: otvar132 ($167.10 in chips) 
fightingnuns: posts small blind $2
otvar132: posts big blind $4
*** HOLE CARDS ***
Dealt to fightingnuns [Th 4c]
fightingnuns: folds 
Uncalled bet ($2) returned to otvar132
otvar132 collected $4 from pot
otvar132: doesn't show hand 
*** SUMMARY ***
Total pot $4 | Rake $0 
Seat 1: fightingnuns (button) (small blind) folded before Flop
Seat 2: otvar132 (big blind) collected ($4)



PokerStars Game #59917214173:  Hold'em No Limit ($2/$4 USD) - 2011/03/27 19:12:14 ET
Table 'Pulcherrima XI' 2-max Seat #2 is the button
Seat 1: fightingnuns ($1159.65 in chips) 
Seat 2: otvar132 ($169.10 in chips) 
otvar132: posts small blind $2
fightingnuns: posts big blind $4
*** HOLE CARDS ***
Dealt to fightingnuns [9c 3h]
otvar132: raises $8 to $12
fightingnuns: folds 
Uncalled bet ($8) returned to otvar132
otvar132 collected $8 from pot
otvar132: doesn't show hand 
*** SUMMARY ***
Total pot $8 | Rake $0 
Seat 1: fightingnuns (big blind) folded before Flop
Seat 2: otvar132 (button) (small blind) collected ($8)



PokerStars Game #59917220908:  Hold'em No Limit ($2/$4 USD) - 2011/03/27 19:12:23 ET
Table 'Pulcherrima XI' 2-max Seat #1 is the button
Seat 1: fightingnuns ($1155.65 in chips) 
Seat 2: otvar132 ($173.10 in chips) 
fightingnuns: posts small blind $2
otvar132: posts big blind $4
*** HOLE CARDS ***
Dealt to fightingnuns [Ac 3h]
fightingnuns: raises $8 to $12
otvar132: calls $8
*** FLOP *** [6h Qs Kd]
otvar132: checks 
fightingnuns: checks 
*** TURN *** [6h Qs Kd] [4h]
otvar132: checks 
fightingnuns: checks 
*** RIVER *** [6h Qs Kd 4h] [Tc]
otvar132: checks 
fightingnuns: checks 
*** SHOW DOWN ***
otvar132: shows [8c 9s] (high card King)
fightingnuns: shows [Ac 3h] (high card Ace)
fightingnuns collected $23.50 from pot
*** SUMMARY ***
Total pot $24 | Rake $0.50 
Board [6h Qs Kd 4h Tc]
Seat 1: fightingnuns (button) (small blind) showed [Ac 3h] and won ($23.50) with high card Ace
Seat 2: otvar132 (big blind) showed [8c 9s] and lost with high card King



PokerStars Game #59917239721:  Hold'em No Limit ($2/$4 USD) - 2011/03/27 19:12:43 ET
Table 'Pulcherrima XI' 2-max Seat #2 is the button
Seat 1: fightingnuns ($1167.15 in chips) 
Seat 2: otvar132 ($161.10 in chips) 
otvar132: posts small blind $2
fightingnuns: posts big blind $4
*** HOLE CARDS ***
Dealt to fightingnuns [6d Ts]
otvar132: folds 
Uncalled bet ($2) returned to fightingnuns
fightingnuns collected $4 from pot
fightingnuns: doesn't show hand 
*** SUMMARY ***
Total pot $4 | Rake $0 
Seat 1: fightingnuns (big blind) collected ($4)
Seat 2: otvar132 (button) (small blind) folded before Flop



PokerStars Game #59917244731:  Hold'em No Limit ($2/$4 USD) - 2011/03/27 19:12:48 ET
Table 'Pulcherrima XI' 2-max Seat #1 is the button
Seat 1: fightingnuns ($1169.15 in chips) 
Seat 2: otvar132 ($159.10 in chips) 
fightingnuns: posts small blind $2
otvar132: posts big blind $4
*** HOLE CARDS ***
Dealt to fightingnuns [8c As]
fightingnuns: raises $8 to $12
otvar132: calls $8
*** FLOP *** [Ac Ah 8d]
otvar132: checks 
fightingnuns: bets $16
otvar132: folds 
Uncalled bet ($16) returned to fightingnuns
fightingnuns collected $23.50 from pot
fightingnuns: doesn't show hand 
*** SUMMARY ***
Total pot $24 | Rake $0.50 
Board [Ac Ah 8d]
Seat 1: fightingnuns (button) (small blind) collected ($23.50)
Seat 2: otvar132 (big blind) folded on the Flop



PokerStars Game #59917258176:  Hold'em No Limit ($2/$4 USD) - 2011/03/27 19:13:03 ET
Table 'Pulcherrima XI' 2-max Seat #2 is the button
Seat 1: fightingnuns ($1180.65 in chips) 
Seat 2: otvar132 ($147.10 in chips) 
otvar132: posts small blind $2
fightingnuns: posts big blind $4
*** HOLE CARDS ***
Dealt to fightingnuns [5c 6s]
otvar132: raises $8 to $12
fightingnuns: folds 
Uncalled bet ($8) returned to otvar132
otvar132 collected $8 from pot
*** SUMMARY ***
Total pot $8 | Rake $0 
Seat 1: fightingnuns (big blind) folded before Flop
Seat 2: otvar132 (button) (small blind) collected ($8)



PokerStars Game #59917265419:  Hold'em No Limit ($2/$4 USD) - 2011/03/27 19:13:11 ET
Table 'Pulcherrima XI' 2-max Seat #1 is the button
Seat 1: fightingnuns ($1176.65 in chips) 
Seat 2: otvar132 ($151.10 in chips) 
fightingnuns: posts small blind $2
otvar132: posts big blind $4
*** HOLE CARDS ***
Dealt to fightingnuns [8h 2s]
fightingnuns: folds 
Uncalled bet ($2) returned to otvar132
otvar132 collected $4 from pot
otvar132: doesn't show hand 
*** SUMMARY ***
Total pot $4 | Rake $0 
Seat 1: fightingnuns (button) (small blind) folded before Flop
Seat 2: otvar132 (big blind) collected ($4)



PokerStars Game #59917270134:  Hold'em No Limit ($2/$4 USD) - 2011/03/27 19:13:16 ET
Table 'Pulcherrima XI' 2-max Seat #2 is the button
Seat 1: fightingnuns ($1174.65 in chips) 
Seat 2: otvar132 ($153.10 in chips) 
otvar132: posts small blind $2
fightingnuns: posts big blind $4
*** HOLE CARDS ***
Dealt to fightingnuns [9s 7c]
otvar132: calls $2
fightingnuns: checks 
*** FLOP *** [2c 3c Ah]
fightingnuns: checks 
otvar132: bets $4
fightingnuns: folds 
Uncalled bet ($4) returned to otvar132
otvar132 collected $7.60 from pot
otvar132: doesn't show hand 
*** SUMMARY ***
Total pot $8 | Rake $0.40 
Board [2c 3c Ah]
Seat 1: fightingnuns (big blind) folded on the Flop
Seat 2: otvar132 (button) (small blind) collected ($7.60)



PokerStars Game #59917281268:  Hold'em No Limit ($2/$4 USD) - 2011/03/27 19:13:29 ET
Table 'Pulcherrima XI' 2-max Seat #1 is the button
Seat 1: fightingnuns ($1170.65 in chips) 
Seat 2: otvar132 ($156.70 in chips) 
fightingnuns: posts small blind $2
otvar132: posts big blind $4
*** HOLE CARDS ***
Dealt to fightingnuns [2h 7c]
fightingnuns: folds 
Uncalled bet ($2) returned to otvar132
otvar132 collected $4 from pot
otvar132: doesn't show hand 
*** SUMMARY ***
Total pot $4 | Rake $0 
Seat 1: fightingnuns (button) (small blind) folded before Flop
Seat 2: otvar132 (big blind) collected ($4)



PokerStars Game #59917286755:  Hold'em No Limit ($2/$4 USD) - 2011/03/27 19:13:35 ET
Table 'Pulcherrima XI' 2-max Seat #2 is the button
Seat 1: fightingnuns ($1168.65 in chips) 
Seat 2: otvar132 ($158.70 in chips) 
otvar132: posts small blind $2
fightingnuns: posts big blind $4
*** HOLE CARDS ***
Dealt to fightingnuns [3c Qd]
otvar132: calls $2
fightingnuns: checks 
*** FLOP *** [Qh 3h Ah]
fightingnuns: bets $16
otvar132: calls $16
*** TURN *** [Qh 3h Ah] [Ks]
fightingnuns: bets $28
otvar132: calls $28
*** RIVER *** [Qh 3h Ah Ks] [7d]
fightingnuns: bets $44
otvar132: folds 
Uncalled bet ($44) returned to fightingnuns
fightingnuns collected $95.50 from pot
fightingnuns: doesn't show hand 
*** SUMMARY ***
Total pot $96 | Rake $0.50 
Board [Qh 3h Ah Ks 7d]
Seat 1: fightingnuns (big blind) collected ($95.50)
Seat 2: otvar132 (button) (small blind) folded on the River



PokerStars Game #59917308778:  Hold'em No Limit ($2/$4 USD) - 2011/03/27 19:13:59 ET
Table 'Pulcherrima XI' 2-max Seat #1 is the button
Seat 1: fightingnuns ($1216.15 in chips) 
Seat 2: otvar132 ($110.70 in chips) 
fightingnuns: posts small blind $2
otvar132: posts big blind $4
*** HOLE CARDS ***
Dealt to fightingnuns [3c 3d]
fightingnuns: raises $8 to $12
otvar132: raises $20 to $32
fightingnuns: folds 
Uncalled bet ($20) returned to otvar132
otvar132 collected $24 from pot
otvar132: doesn't show hand 
*** SUMMARY ***
Total pot $24 | Rake $0 
Seat 1: fightingnuns (button) (small blind) folded before Flop
Seat 2: otvar132 (big blind) collected ($24)



PokerStars Game #59917317951:  Hold'em No Limit ($2/$4 USD) - 2011/03/27 19:14:09 ET
Table 'Pulcherrima XI' 2-max Seat #2 is the button
Seat 1: fightingnuns ($1204.15 in chips) 
Seat 2: otvar132 ($122.70 in chips) 
otvar132: posts small blind $2
fightingnuns: posts big blind $4
*** HOLE CARDS ***
Dealt to fightingnuns [Th 9h]
otvar132: folds 
Uncalled bet ($2) returned to fightingnuns
fightingnuns collected $4 from pot
fightingnuns: doesn't show hand 
*** SUMMARY ***
Total pot $4 | Rake $0 
Seat 1: fightingnuns (big blind) collected ($4)
Seat 2: otvar132 (button) (small blind) folded before Flop



PokerStars Game #59917323202:  Hold'em No Limit ($2/$4 USD) - 2011/03/27 19:14:15 ET
Table 'Pulcherrima XI' 2-max Seat #1 is the button
Seat 1: fightingnuns ($1206.15 in chips) 
Seat 2: otvar132 ($120.70 in chips) 
fightingnuns: posts small blind $2
otvar132: posts big blind $4
*** HOLE CARDS ***
Dealt to fightingnuns [Qh 9d]
fightingnuns: raises $8 to $12
otvar132: calls $8
*** FLOP *** [4d 6d Js]
otvar132: checks 
fightingnuns: bets $16
otvar132: folds 
Uncalled bet ($16) returned to fightingnuns
fightingnuns collected $23.50 from pot
fightingnuns: doesn't show hand 
*** SUMMARY ***
Total pot $24 | Rake $0.50 
Board [4d 6d Js]
Seat 1: fightingnuns (button) (small blind) collected ($23.50)
Seat 2: otvar132 (big blind) folded on the Flop



PokerStars Game #59917335942:  Hold'em No Limit ($2/$4 USD) - 2011/03/27 19:14:30 ET
Table 'Pulcherrima XI' 2-max Seat #2 is the button
Seat 1: fightingnuns ($1217.65 in chips) 
Seat 2: otvar132 ($108.70 in chips) 
otvar132: posts small blind $2
fightingnuns: posts big blind $4
*** HOLE CARDS ***
Dealt to fightingnuns [Jh Qc]
otvar132: calls $2
fightingnuns: raises $12 to $16
otvar132: calls $12
*** FLOP *** [8c Jc 3s]
fightingnuns: checks 
otvar132: checks 
*** TURN *** [8c Jc 3s] [7h]
fightingnuns: bets $28
otvar132: folds 
Uncalled bet ($28) returned to fightingnuns
fightingnuns collected $31.50 from pot
fightingnuns: doesn't show hand 
*** SUMMARY ***
Total pot $32 | Rake $0.50 
Board [8c Jc 3s 7h]
Seat 1: fightingnuns (big blind) collected ($31.50)
Seat 2: otvar132 (button) (small blind) folded on the Turn



PokerStars Game #59917355888:  Hold'em No Limit ($2/$4 USD) - 2011/03/27 19:14:51 ET
Table 'Pulcherrima XI' 2-max Seat #1 is the button
Seat 1: fightingnuns ($1233.15 in chips) 
Seat 2: otvar132 ($92.70 in chips) 
fightingnuns: posts small blind $2
otvar132: posts big blind $4
*** HOLE CARDS ***
Dealt to fightingnuns [2s Qd]
fightingnuns: folds 
Uncalled bet ($2) returned to otvar132
otvar132 collected $4 from pot
*** SUMMARY ***
Total pot $4 | Rake $0 
Seat 1: fightingnuns (button) (small blind) folded before Flop
Seat 2: otvar132 (big blind) collected ($4)



PokerStars Game #59917360453:  Hold'em No Limit ($2/$4 USD) - 2011/03/27 19:14:57 ET
Table 'Pulcherrima XI' 2-max Seat #2 is the button
Seat 1: fightingnuns ($1231.15 in chips) 
Seat 2: otvar132 ($94.70 in chips) 
otvar132: posts small blind $2
fightingnuns: posts big blind $4
*** HOLE CARDS ***
Dealt to fightingnuns [8d 4h]
otvar132: folds 
Uncalled bet ($2) returned to fightingnuns
fightingnuns collected $4 from pot
fightingnuns: doesn't show hand 
*** SUMMARY ***
Total pot $4 | Rake $0 
Seat 1: fightingnuns (big blind) collected ($4)
Seat 2: otvar132 (button) (small blind) folded before Flop



PokerStars Game #59917366223:  Hold'em No Limit ($2/$4 USD) - 2011/03/27 19:15:03 ET
Table 'Pulcherrima XI' 2-max Seat #1 is the button
Seat 1: fightingnuns ($1233.15 in chips) 
Seat 2: otvar132 ($92.70 in chips) 
fightingnuns: posts small blind $2
otvar132: posts big blind $4
*** HOLE CARDS ***
Dealt to fightingnuns [5c As]
fightingnuns: raises $8 to $12
otvar132: raises $24 to $36
fightingnuns: folds 
Uncalled bet ($24) returned to otvar132
otvar132 collected $24 from pot
otvar132: doesn't show hand 
*** SUMMARY ***
Total pot $24 | Rake $0 
Seat 1: fightingnuns (button) (small blind) folded before Flop
Seat 2: otvar132 (big blind) collected ($24)



PokerStars Game #59917376118:  Hold'em No Limit ($2/$4 USD) - 2011/03/27 19:15:14 ET
Table 'Pulcherrima XI' 2-max Seat #2 is the button
Seat 1: fightingnuns ($1221.15 in chips) 
Seat 2: otvar132 ($104.70 in chips) 
otvar132: posts small blind $2
fightingnuns: posts big blind $4
*** HOLE CARDS ***
Dealt to fightingnuns [3h Qc]
otvar132: folds 
Uncalled bet ($2) returned to fightingnuns
fightingnuns collected $4 from pot
fightingnuns: doesn't show hand 
*** SUMMARY ***
Total pot $4 | Rake $0 
Seat 1: fightingnuns (big blind) collected ($4)
Seat 2: otvar132 (button) (small blind) folded before Flop



PokerStars Game #59917385413:  Hold'em No Limit ($2/$4 USD) - 2011/03/27 19:15:24 ET
Table 'Pulcherrima XI' 2-max Seat #1 is the button
Seat 1: fightingnuns ($1223.15 in chips) 
Seat 2: otvar132 ($102.70 in chips) 
fightingnuns: posts small blind $2
otvar132: posts big blind $4
*** HOLE CARDS ***
Dealt to fightingnuns [2c Kh]
fightingnuns: raises $8 to $12
otvar132: calls $8
*** FLOP *** [Jd 7c 4s]
otvar132: bets $4
fightingnuns: calls $4
*** TURN *** [Jd 7c 4s] [6c]
otvar132: bets $4
fightingnuns: calls $4
*** RIVER *** [Jd 7c 4s 6c] [4c]
otvar132: bets $24
fightingnuns: calls $24
*** SHOW DOWN ***
otvar132: shows [4h Th] (three of a kind, Fours)
fightingnuns: mucks hand 
otvar132 collected $87.50 from pot
*** SUMMARY ***
Total pot $88 | Rake $0.50 
Board [Jd 7c 4s 6c 4c]
Seat 1: fightingnuns (button) (small blind) mucked [2c Kh]
Seat 2: otvar132 (big blind) showed [4h Th] and won ($87.50) with three of a kind, Fours



PokerStars Game #59917409257:  Hold'em No Limit ($2/$4 USD) - 2011/03/27 19:15:50 ET
Table 'Pulcherrima XI' 2-max Seat #2 is the button
Seat 1: fightingnuns ($1179.15 in chips) 
Seat 2: otvar132 ($146.20 in chips) 
otvar132: posts small blind $2
fightingnuns: posts big blind $4
*** HOLE CARDS ***
Dealt to fightingnuns [4h 9d]
otvar132: folds 
Uncalled bet ($2) returned to fightingnuns
fightingnuns collected $4 from pot
fightingnuns: doesn't show hand 
*** SUMMARY ***
Total pot $4 | Rake $0 
Seat 1: fightingnuns (big blind) collected ($4)
Seat 2: otvar132 (button) (small blind) folded before Flop



PokerStars Game #59917414962:  Hold'em No Limit ($2/$4 USD) - 2011/03/27 19:15:57 ET
Table 'Pulcherrima XI' 2-max Seat #1 is the button
Seat 1: fightingnuns ($1181.15 in chips) 
Seat 2: otvar132 ($144.20 in chips) 
fightingnuns: posts small blind $2
otvar132: posts big blind $4
*** HOLE CARDS ***
Dealt to fightingnuns [9d As]
fightingnuns: raises $8 to $12
otvar132: calls $8
*** FLOP *** [2h 8c 3d]
otvar132: checks 
fightingnuns: checks 
*** TURN *** [2h 8c 3d] [7c]
otvar132: checks 
fightingnuns: checks 
*** RIVER *** [2h 8c 3d 7c] [6h]
otvar132: checks 
fightingnuns: checks 
*** SHOW DOWN ***
otvar132: shows [Kd 9h] (high card King)
fightingnuns: shows [9d As] (high card Ace)
fightingnuns collected $23.50 from pot
*** SUMMARY ***
Total pot $24 | Rake $0.50 
Board [2h 8c 3d 7c 6h]
Seat 1: fightingnuns (button) (small blind) showed [9d As] and won ($23.50) with high card Ace
Seat 2: otvar132 (big blind) showed [Kd 9h] and lost with high card King



PokerStars Game #59917433597:  Hold'em No Limit ($2/$4 USD) - 2011/03/27 19:16:17 ET
Table 'Pulcherrima XI' 2-max Seat #2 is the button
Seat 1: fightingnuns ($1192.65 in chips) 
Seat 2: otvar132 ($132.20 in chips) 
otvar132: posts small blind $2
fightingnuns: posts big blind $4
*** HOLE CARDS ***
Dealt to fightingnuns [Qd 6h]
otvar132: folds 
Uncalled bet ($2) returned to fightingnuns
fightingnuns collected $4 from pot
fightingnuns: doesn't show hand 
*** SUMMARY ***
Total pot $4 | Rake $0 
Seat 1: fightingnuns (big blind) collected ($4)
Seat 2: otvar132 (button) (small blind) folded before Flop



PokerStars Game #59917439086:  Hold'em No Limit ($2/$4 USD) - 2011/03/27 19:16:23 ET
Table 'Pulcherrima XI' 2-max Seat #1 is the button
Seat 1: fightingnuns ($1194.65 in chips) 
Seat 2: otvar132 ($130.20 in chips) 
fightingnuns: posts small blind $2
otvar132: posts big blind $4
*** HOLE CARDS ***
Dealt to fightingnuns [Ah 9c]
fightingnuns: raises $8 to $12
otvar132: raises $8 to $20
fightingnuns: calls $8
*** FLOP *** [2s 6d 3h]
otvar132: bets $12
fightingnuns: calls $12
*** TURN *** [2s 6d 3h] [7c]
otvar132: bets $16
fightingnuns: folds 
Uncalled bet ($16) returned to otvar132
otvar132 collected $63.50 from pot
otvar132: doesn't show hand 
*** SUMMARY ***
Total pot $64 | Rake $0.50 
Board [2s 6d 3h 7c]
Seat 1: fightingnuns (button) (small blind) folded on the Turn
Seat 2: otvar132 (big blind) collected ($63.50)



PokerStars Game #59917458580:  Hold'em No Limit ($2/$4 USD) - 2011/03/27 19:16:45 ET
Table 'Pulcherrima XI' 2-max Seat #2 is the button
Seat 1: fightingnuns ($1162.65 in chips) 
Seat 2: otvar132 ($161.70 in chips) 
otvar132: posts small blind $2
fightingnuns: posts big blind $4
*** HOLE CARDS ***
Dealt to fightingnuns [2h 2c]
otvar132: calls $2
fightingnuns: checks 
*** FLOP *** [9h 8h As]
fightingnuns: checks 
otvar132: checks 
*** TURN *** [9h 8h As] [5d]
fightingnuns: checks 
otvar132: checks 
*** RIVER *** [9h 8h As 5d] [Js]
fightingnuns: checks 
otvar132: bets $4
fightingnuns: folds 
Uncalled bet ($4) returned to otvar132
otvar132 collected $7.60 from pot
otvar132: doesn't show hand 
*** SUMMARY ***
Total pot $8 | Rake $0.40 
Board [9h 8h As 5d Js]
Seat 1: fightingnuns (big blind) folded on the River
Seat 2: otvar132 (button) (small blind) collected ($7.60)



PokerStars Game #59917475677:  Hold'em No Limit ($2/$4 USD) - 2011/03/27 19:17:04 ET
Table 'Pulcherrima XI' 2-max Seat #1 is the button
Seat 1: fightingnuns ($1158.65 in chips) 
Seat 2: otvar132 ($165.30 in chips) 
fightingnuns: posts small blind $2
otvar132: posts big blind $4
*** HOLE CARDS ***
Dealt to fightingnuns [Th 7h]
fightingnuns: raises $8 to $12
otvar132: calls $8
*** FLOP *** [4d 7c 6c]
otvar132: checks 
fightingnuns: bets $16
otvar132: folds 
Uncalled bet ($16) returned to fightingnuns
fightingnuns collected $23.50 from pot
fightingnuns: doesn't show hand 
*** SUMMARY ***
Total pot $24 | Rake $0.50 
Board [4d 7c 6c]
Seat 1: fightingnuns (button) (small blind) collected ($23.50)
Seat 2: otvar132 (big blind) folded on the Flop



PokerStars Game #59917487736:  Hold'em No Limit ($2/$4 USD) - 2011/03/27 19:17:18 ET
Table 'Pulcherrima XI' 2-max Seat #2 is the button
Seat 1: fightingnuns ($1170.15 in chips) 
Seat 2: otvar132 ($153.30 in chips) 
otvar132: posts small blind $2
fightingnuns: posts big blind $4
*** HOLE CARDS ***
Dealt to fightingnuns [6c As]
otvar132: raises $4 to $8
fightingnuns: folds 
Uncalled bet ($4) returned to otvar132
otvar132 collected $8 from pot
otvar132: doesn't show hand 
*** SUMMARY ***
Total pot $8 | Rake $0 
Seat 1: fightingnuns (big blind) folded before Flop
Seat 2: otvar132 (button) (small blind) collected ($8)



PokerStars Game #59917493951:  Hold'em No Limit ($2/$4 USD) - 2011/03/27 19:17:25 ET
Table 'Pulcherrima XI' 2-max Seat #1 is the button
Seat 1: fightingnuns ($1166.15 in chips) 
Seat 2: otvar132 ($157.30 in chips) 
fightingnuns: posts small blind $2
otvar132: posts big blind $4
*** HOLE CARDS ***
Dealt to fightingnuns [Ts 2h]
fightingnuns: folds 
Uncalled bet ($2) returned to otvar132
otvar132 collected $4 from pot
otvar132: doesn't show hand 
*** SUMMARY ***
Total pot $4 | Rake $0 
Seat 1: fightingnuns (button) (small blind) folded before Flop
Seat 2: otvar132 (big blind) collected ($4)



PokerStars Game #59917498622:  Hold'em No Limit ($2/$4 USD) - 2011/03/27 19:17:31 ET
Table 'Pulcherrima XI' 2-max Seat #2 is the button
Seat 1: fightingnuns ($1164.15 in chips) 
Seat 2: otvar132 ($159.30 in chips) 
otvar132: posts small blind $2
fightingnuns: posts big blind $4
*** HOLE CARDS ***
Dealt to fightingnuns [Ah Qs]
otvar132: calls $2
fightingnuns: raises $16 to $20
otvar132: calls $16
*** FLOP *** [Td 2c 5d]
fightingnuns: bets $24
otvar132: folds 
Uncalled bet ($24) returned to fightingnuns
fightingnuns collected $39.50 from pot
fightingnuns: doesn't show hand 
*** SUMMARY ***
Total pot $40 | Rake $0.50 
Board [Td 2c 5d]
Seat 1: fightingnuns (big blind) collected ($39.50)
Seat 2: otvar132 (button) (small blind) folded on the Flop



PokerStars Game #59917512505:  Hold'em No Limit ($2/$4 USD) - 2011/03/27 19:17:45 ET
Table 'Pulcherrima XI' 2-max Seat #1 is the button
Seat 1: fightingnuns ($1183.65 in chips) 
Seat 2: otvar132 ($139.30 in chips) 
fightingnuns: posts small blind $2
otvar132: posts big blind $4
*** HOLE CARDS ***
Dealt to fightingnuns [6c 7d]
fightingnuns: raises $8 to $12
otvar132: raises $40 to $52
fightingnuns: folds 
Uncalled bet ($40) returned to otvar132
otvar132 collected $24 from pot
otvar132: doesn't show hand 
*** SUMMARY ***
Total pot $24 | Rake $0 
Seat 1: fightingnuns (button) (small blind) folded before Flop
Seat 2: otvar132 (big blind) collected ($24)



PokerStars Game #59917521963:  Hold'em No Limit ($2/$4 USD) - 2011/03/27 19:17:56 ET
Table 'Pulcherrima XI' 2-max Seat #2 is the button
Seat 1: fightingnuns ($1171.65 in chips) 
Seat 2: otvar132 ($151.30 in chips) 
otvar132: posts small blind $2
fightingnuns: posts big blind $4
*** HOLE CARDS ***
Dealt to fightingnuns [9c 4h]
otvar132: raises $12 to $16
fightingnuns: folds 
Uncalled bet ($12) returned to otvar132
otvar132 collected $8 from pot
otvar132: doesn't show hand 
*** SUMMARY ***
Total pot $8 | Rake $0 
Seat 1: fightingnuns (big blind) folded before Flop
Seat 2: otvar132 (button) (small blind) collected ($8)



PokerStars Game #59917528769:  Hold'em No Limit ($2/$4 USD) - 2011/03/27 19:18:04 ET
Table 'Pulcherrima XI' 2-max Seat #1 is the button
Seat 1: fightingnuns ($1167.65 in chips) 
Seat 2: otvar132 ($155.30 in chips) 
fightingnuns: posts small blind $2
otvar132: posts big blind $4
*** HOLE CARDS ***
Dealt to fightingnuns [9h 5c]
fightingnuns: folds 
Uncalled bet ($2) returned to otvar132
otvar132 collected $4 from pot
otvar132: doesn't show hand 
*** SUMMARY ***
Total pot $4 | Rake $0 
Seat 1: fightingnuns (button) (small blind) folded before Flop
Seat 2: otvar132 (big blind) collected ($4)



PokerStars Game #59917534386:  Hold'em No Limit ($2/$4 USD) - 2011/03/27 19:18:10 ET
Table 'Pulcherrima XI' 2-max Seat #2 is the button
Seat 1: fightingnuns ($1165.65 in chips) 
Seat 2: otvar132 ($157.30 in chips) 
otvar132: posts small blind $2
fightingnuns: posts big blind $4
*** HOLE CARDS ***
Dealt to fightingnuns [Kd 2h]
otvar132: folds 
Uncalled bet ($2) returned to fightingnuns
fightingnuns collected $4 from pot
fightingnuns: doesn't show hand 
*** SUMMARY ***
Total pot $4 | Rake $0 
Seat 1: fightingnuns (big blind) collected ($4)
Seat 2: otvar132 (button) (small blind) folded before Flop



PokerStars Game #59917540082:  Hold'em No Limit ($2/$4 USD) - 2011/03/27 19:18:16 ET
Table 'Pulcherrima XI' 2-max Seat #1 is the button
Seat 1: fightingnuns ($1167.65 in chips) 
Seat 2: otvar132 ($155.30 in chips) 
fightingnuns: posts small blind $2
otvar132: posts big blind $4
*** HOLE CARDS ***
Dealt to fightingnuns [Kc 7s]
fightingnuns: raises $8 to $12
otvar132: calls $8
*** FLOP *** [8h Th Jh]
otvar132: checks 
fightingnuns: checks 
*** TURN *** [8h Th Jh] [5h]
otvar132: checks 
fightingnuns: checks 
*** RIVER *** [8h Th Jh 5h] [Qh]
otvar132: checks 
fightingnuns: checks 
*** SHOW DOWN ***
otvar132: shows [8s 9c] (a flush, Queen high)
fightingnuns: shows [Kc 7s] (a flush, Queen high)
otvar132 collected $11.75 from pot
fightingnuns collected $11.75 from pot
*** SUMMARY ***
Total pot $24 | Rake $0.50 
Board [8h Th Jh 5h Qh]
Seat 1: fightingnuns (button) (small blind) showed [Kc 7s] and won ($11.75) with a flush, Queen high
Seat 2: otvar132 (big blind) showed [8s 9c] and won ($11.75) with a flush, Queen high



PokerStars Game #59917562890:  Hold'em No Limit ($2/$4 USD) - 2011/03/27 19:18:41 ET
Table 'Pulcherrima XI' 2-max Seat #2 is the button
Seat 1: fightingnuns ($1167.40 in chips) 
Seat 2: otvar132 ($155.05 in chips) 
otvar132: posts small blind $2
fightingnuns: posts big blind $4
*** HOLE CARDS ***
Dealt to fightingnuns [9s 3h]
otvar132: folds 
Uncalled bet ($2) returned to fightingnuns
fightingnuns collected $4 from pot
fightingnuns: doesn't show hand 
*** SUMMARY ***
Total pot $4 | Rake $0 
Seat 1: fightingnuns (big blind) collected ($4)
Seat 2: otvar132 (button) (small blind) folded before Flop



PokerStars Game #59917568899:  Hold'em No Limit ($2/$4 USD) - 2011/03/27 19:18:48 ET
Table 'Pulcherrima XI' 2-max Seat #1 is the button
Seat 1: fightingnuns ($1169.40 in chips) 
Seat 2: otvar132 ($153.05 in chips) 
fightingnuns: posts small blind $2
otvar132: posts big blind $4
*** HOLE CARDS ***
Dealt to fightingnuns [5s Jc]
fightingnuns: folds 
Uncalled bet ($2) returned to otvar132
otvar132 collected $4 from pot
otvar132: doesn't show hand 
*** SUMMARY ***
Total pot $4 | Rake $0 
Seat 1: fightingnuns (button) (small blind) folded before Flop
Seat 2: otvar132 (big blind) collected ($4)



PokerStars Game #59917573819:  Hold'em No Limit ($2/$4 USD) - 2011/03/27 19:18:54 ET
Table 'Pulcherrima XI' 2-max Seat #2 is the button
Seat 1: fightingnuns ($1167.40 in chips) 
Seat 2: otvar132 ($155.05 in chips) 
otvar132: posts small blind $2
fightingnuns: posts big blind $4
*** HOLE CARDS ***
Dealt to fightingnuns [9h Ks]
otvar132: raises $4 to $8
fightingnuns: calls $4
*** FLOP *** [Kd 7s Js]
fightingnuns: checks 
otvar132: checks 
*** TURN *** [Kd 7s Js] [7c]
fightingnuns: bets $16
otvar132: raises $16 to $32
fightingnuns: folds 
Uncalled bet ($16) returned to otvar132
otvar132 collected $47.50 from pot
otvar132: doesn't show hand 
*** SUMMARY ***
Total pot $48 | Rake $0.50 
Board [Kd 7s Js 7c]
Seat 1: fightingnuns (big blind) folded on the Turn
Seat 2: otvar132 (button) (small blind) collected ($47.50)



PokerStars Game #59917590329:  Hold'em No Limit ($2/$4 USD) - 2011/03/27 19:19:12 ET
Table 'Pulcherrima XI' 2-max Seat #1 is the button
Seat 1: fightingnuns ($1143.40 in chips) 
Seat 2: otvar132 ($178.55 in chips) 
fightingnuns: posts small blind $2
otvar132: posts big blind $4
*** HOLE CARDS ***
Dealt to fightingnuns [7s 6d]
fightingnuns: raises $8 to $12
otvar132: calls $8
*** FLOP *** [Ah As 3h]
otvar132: checks 
fightingnuns: bets $16
otvar132: folds 
Uncalled bet ($16) returned to fightingnuns
fightingnuns collected $23.50 from pot
fightingnuns: doesn't show hand 
*** SUMMARY ***
Total pot $24 | Rake $0.50 
Board [Ah As 3h]
Seat 1: fightingnuns (button) (small blind) collected ($23.50)
Seat 2: otvar132 (big blind) folded on the Flop



PokerStars Game #59917607704:  Hold'em No Limit ($2/$4 USD) - 2011/03/27 19:19:32 ET
Table 'Pulcherrima XI' 2-max Seat #2 is the button
Seat 1: fightingnuns ($1154.90 in chips) 
Seat 2: otvar132 ($166.55 in chips) 
otvar132: posts small blind $2
fightingnuns: posts big blind $4
*** HOLE CARDS ***
Dealt to fightingnuns [2h 7s]
otvar132: folds 
Uncalled bet ($2) returned to fightingnuns
fightingnuns collected $4 from pot
fightingnuns: doesn't show hand 
*** SUMMARY ***
Total pot $4 | Rake $0 
Seat 1: fightingnuns (big blind) collected ($4)
Seat 2: otvar132 (button) (small blind) folded before Flop



PokerStars Game #59917613130:  Hold'em No Limit ($2/$4 USD) - 2011/03/27 19:19:38 ET
Table 'Pulcherrima XI' 2-max Seat #1 is the button
Seat 1: fightingnuns ($1156.90 in chips) 
Seat 2: otvar132 ($164.55 in chips) 
fightingnuns: posts small blind $2
otvar132: posts big blind $4
*** HOLE CARDS ***
Dealt to fightingnuns [Ac Jd]
fightingnuns: raises $8 to $12
otvar132: raises $8 to $20
fightingnuns: calls $8
*** FLOP *** [3s 2c Ts]
otvar132: bets $4
fightingnuns: calls $4
*** TURN *** [3s 2c Ts] [5d]
otvar132: bets $4
fightingnuns: calls $4
*** RIVER *** [3s 2c Ts 5d] [4h]
otvar132: bets $40
fightingnuns: calls $40
*** SHOW DOWN ***
otvar132: shows [5h Ah] (a straight, Ace to Five)
fightingnuns: shows [Ac Jd] (a straight, Ace to Five)
otvar132 collected $67.75 from pot
fightingnuns collected $67.75 from pot
*** SUMMARY ***
Total pot $136 | Rake $0.50 
Board [3s 2c Ts 5d 4h]
Seat 1: fightingnuns (button) (small blind) showed [Ac Jd] and won ($67.75) with a straight, Ace to Five
Seat 2: otvar132 (big blind) showed [5h Ah] and won ($67.75) with a straight, Ace to Five



PokerStars Game #59917638517:  Hold'em No Limit ($2/$4 USD) - 2011/03/27 19:20:06 ET
Table 'Pulcherrima XI' 2-max Seat #2 is the button
Seat 1: fightingnuns ($1156.65 in chips) 
Seat 2: otvar132 ($164.30 in chips) 
otvar132: posts small blind $2
fightingnuns: posts big blind $4
*** HOLE CARDS ***
Dealt to fightingnuns [Jh Qd]
otvar132: calls $2
fightingnuns: raises $16 to $20
otvar132: calls $16
*** FLOP *** [4s 7c 5c]
fightingnuns: checks 
otvar132: bets $12
fightingnuns: folds 
Uncalled bet ($12) returned to otvar132
otvar132 collected $39.50 from pot
otvar132: doesn't show hand 
*** SUMMARY ***
Total pot $40 | Rake $0.50 
Board [4s 7c 5c]
Seat 1: fightingnuns (big blind) folded on the Flop
Seat 2: otvar132 (button) (small blind) collected ($39.50)



PokerStars Game #59917654424:  Hold'em No Limit ($2/$4 USD) - 2011/03/27 19:20:24 ET
Table 'Pulcherrima XI' 2-max Seat #1 is the button
Seat 1: fightingnuns ($1136.65 in chips) 
Seat 2: otvar132 ($183.80 in chips) 
fightingnuns: posts small blind $2
otvar132: posts big blind $4
*** HOLE CARDS ***
Dealt to fightingnuns [9h 4d]
fightingnuns: folds 
Uncalled bet ($2) returned to otvar132
otvar132 collected $4 from pot
otvar132: doesn't show hand 
*** SUMMARY ***
Total pot $4 | Rake $0 
Seat 1: fightingnuns (button) (small blind) folded before Flop
Seat 2: otvar132 (big blind) collected ($4)



PokerStars Game #59917659326:  Hold'em No Limit ($2/$4 USD) - 2011/03/27 19:20:30 ET
Table 'Pulcherrima XI' 2-max Seat #2 is the button
Seat 1: fightingnuns ($1134.65 in chips) 
Seat 2: otvar132 ($185.80 in chips) 
otvar132: posts small blind $2
fightingnuns: posts big blind $4
*** HOLE CARDS ***
Dealt to fightingnuns [2h 5s]
otvar132: raises $8 to $12
fightingnuns: folds 
Uncalled bet ($8) returned to otvar132
otvar132 collected $8 from pot
otvar132: doesn't show hand 
*** SUMMARY ***
Total pot $8 | Rake $0 
Seat 1: fightingnuns (big blind) folded before Flop
Seat 2: otvar132 (button) (small blind) collected ($8)



PokerStars Game #59917666138:  Hold'em No Limit ($2/$4 USD) - 2011/03/27 19:20:38 ET
Table 'Pulcherrima XI' 2-max Seat #1 is the button
Seat 1: fightingnuns ($1130.65 in chips) 
Seat 2: otvar132 ($189.80 in chips) 
fightingnuns: posts small blind $2
otvar132: posts big blind $4
*** HOLE CARDS ***
Dealt to fightingnuns [3h 6s]
fightingnuns: folds 
Uncalled bet ($2) returned to otvar132
otvar132 collected $4 from pot
otvar132: doesn't show hand 
*** SUMMARY ***
Total pot $4 | Rake $0 
Seat 1: fightingnuns (button) (small blind) folded before Flop
Seat 2: otvar132 (big blind) collected ($4)



PokerStars Game #59917670988:  Hold'em No Limit ($2/$4 USD) - 2011/03/27 19:20:43 ET
Table 'Pulcherrima XI' 2-max Seat #2 is the button
Seat 1: fightingnuns ($1128.65 in chips) 
Seat 2: otvar132 ($191.80 in chips) 
otvar132: posts small blind $2
fightingnuns: posts big blind $4
*** HOLE CARDS ***
Dealt to fightingnuns [Js 9d]
otvar132: folds 
Uncalled bet ($2) returned to fightingnuns
fightingnuns collected $4 from pot
fightingnuns: doesn't show hand 
*** SUMMARY ***
Total pot $4 | Rake $0 
Seat 1: fightingnuns (big blind) collected ($4)
Seat 2: otvar132 (button) (small blind) folded before Flop



PokerStars Game #59917677048:  Hold'em No Limit ($2/$4 USD) - 2011/03/27 19:20:50 ET
Table 'Pulcherrima XI' 2-max Seat #1 is the button
Seat 1: fightingnuns ($1130.65 in chips) 
Seat 2: otvar132 ($189.80 in chips) 
fightingnuns: posts small blind $2
otvar132: posts big blind $4
*** HOLE CARDS ***
Dealt to fightingnuns [Kc Jc]
fightingnuns: raises $8 to $12
otvar132: folds 
Uncalled bet ($8) returned to fightingnuns
fightingnuns collected $8 from pot
fightingnuns: doesn't show hand 
*** SUMMARY ***
Total pot $8 | Rake $0 
Seat 1: fightingnuns (button) (small blind) collected ($8)
Seat 2: otvar132 (big blind) folded before Flop



PokerStars Game #59917683643:  Hold'em No Limit ($2/$4 USD) - 2011/03/27 19:20:57 ET
Table 'Pulcherrima XI' 2-max Seat #2 is the button
Seat 1: fightingnuns ($1134.65 in chips) 
Seat 2: otvar132 ($185.80 in chips) 
otvar132: posts small blind $2
fightingnuns: posts big blind $4
*** HOLE CARDS ***
Dealt to fightingnuns [8h Td]
otvar132: calls $2
fightingnuns: checks 
*** FLOP *** [Kd Tc Jc]
fightingnuns: checks 
otvar132: checks 
*** TURN *** [Kd Tc Jc] [As]
fightingnuns: checks 
otvar132: bets $12
fightingnuns: folds 
Uncalled bet ($12) returned to otvar132
otvar132 collected $7.60 from pot
otvar132: doesn't show hand 
*** SUMMARY ***
Total pot $8 | Rake $0.40 
Board [Kd Tc Jc As]
Seat 1: fightingnuns (big blind) folded on the Turn
Seat 2: otvar132 (button) (small blind) collected ($7.60)



PokerStars Game #59917696518:  Hold'em No Limit ($2/$4 USD) - 2011/03/27 19:21:12 ET
Table 'Pulcherrima XI' 2-max Seat #1 is the button
Seat 1: fightingnuns ($1130.65 in chips) 
Seat 2: otvar132 ($189.40 in chips) 
fightingnuns: posts small blind $2
otvar132: posts big blind $4
*** HOLE CARDS ***
Dealt to fightingnuns [2h Jh]
fightingnuns: raises $8 to $12
otvar132: raises $24 to $36
fightingnuns: folds 
Uncalled bet ($24) returned to otvar132
otvar132 collected $24 from pot
otvar132: doesn't show hand 
*** SUMMARY ***
Total pot $24 | Rake $0 
Seat 1: fightingnuns (button) (small blind) folded before Flop
Seat 2: otvar132 (big blind) collected ($24)



PokerStars Game #59917705291:  Hold'em No Limit ($2/$4 USD) - 2011/03/27 19:21:22 ET
Table 'Pulcherrima XI' 2-max Seat #2 is the button
Seat 1: fightingnuns ($1118.65 in chips) 
Seat 2: otvar132 ($201.40 in chips) 
otvar132: posts small blind $2
fightingnuns: posts big blind $4
*** HOLE CARDS ***
Dealt to fightingnuns [2d 8s]
otvar132: calls $2
fightingnuns: checks 
*** FLOP *** [2h Ts 3h]
fightingnuns: checks 
otvar132: bets $12
fightingnuns: folds 
Uncalled bet ($12) returned to otvar132
otvar132 collected $7.60 from pot
otvar132: doesn't show hand 
*** SUMMARY ***
Total pot $8 | Rake $0.40 
Board [2h Ts 3h]
Seat 1: fightingnuns (big blind) folded on the Flop
Seat 2: otvar132 (button) (small blind) collected ($7.60)



PokerStars Game #59917715832:  Hold'em No Limit ($2/$4 USD) - 2011/03/27 19:21:34 ET
Table 'Pulcherrima XI' 2-max Seat #1 is the button
Seat 1: fightingnuns ($1114.65 in chips) 
Seat 2: otvar132 ($205 in chips) 
fightingnuns: posts small blind $2
otvar132: posts big blind $4
*** HOLE CARDS ***
Dealt to fightingnuns [Kc Js]
fightingnuns: raises $8 to $12
otvar132: folds 
Uncalled bet ($8) returned to fightingnuns
fightingnuns collected $8 from pot
fightingnuns: doesn't show hand 
*** SUMMARY ***
Total pot $8 | Rake $0 
Seat 1: fightingnuns (button) (small blind) collected ($8)
Seat 2: otvar132 (big blind) folded before Flop



PokerStars Game #59917722611:  Hold'em No Limit ($2/$4 USD) - 2011/03/27 19:21:41 ET
Table 'Pulcherrima XI' 2-max Seat #2 is the button
Seat 1: fightingnuns ($1118.65 in chips) 
Seat 2: otvar132 ($201 in chips) 
otvar132: posts small blind $2
fightingnuns: posts big blind $4
*** HOLE CARDS ***
Dealt to fightingnuns [9h 5d]
otvar132: raises $8 to $12
fightingnuns: folds 
Uncalled bet ($8) returned to otvar132
otvar132 collected $8 from pot
otvar132: doesn't show hand 
*** SUMMARY ***
Total pot $8 | Rake $0 
Seat 1: fightingnuns (big blind) folded before Flop
Seat 2: otvar132 (button) (small blind) collected ($8)



PokerStars Game #59917728943:  Hold'em No Limit ($2/$4 USD) - 2011/03/27 19:21:49 ET
Table 'Pulcherrima XI' 2-max Seat #1 is the button
Seat 1: fightingnuns ($1114.65 in chips) 
Seat 2: otvar132 ($205 in chips) 
fightingnuns: posts small blind $2
otvar132: posts big blind $4
*** HOLE CARDS ***
Dealt to fightingnuns [2h Kc]
fightingnuns: raises $8 to $12
otvar132: folds 
Uncalled bet ($8) returned to fightingnuns
fightingnuns collected $8 from pot
fightingnuns: doesn't show hand 
*** SUMMARY ***
Total pot $8 | Rake $0 
Seat 1: fightingnuns (button) (small blind) collected ($8)
Seat 2: otvar132 (big blind) folded before Flop



PokerStars Game #59917735664:  Hold'em No Limit ($2/$4 USD) - 2011/03/27 19:21:56 ET
Table 'Pulcherrima XI' 2-max Seat #2 is the button
Seat 1: fightingnuns ($1118.65 in chips) 
Seat 2: otvar132 ($201 in chips) 
otvar132: posts small blind $2
fightingnuns: posts big blind $4
*** HOLE CARDS ***
Dealt to fightingnuns [Ts 3c]
otvar132: folds 
Uncalled bet ($2) returned to fightingnuns
fightingnuns collected $4 from pot
fightingnuns: doesn't show hand 
*** SUMMARY ***
Total pot $4 | Rake $0 
Seat 1: fightingnuns (big blind) collected ($4)
Seat 2: otvar132 (button) (small blind) folded before Flop



PokerStars Game #59917742209:  Hold'em No Limit ($2/$4 USD) - 2011/03/27 19:22:03 ET
Table 'Pulcherrima XI' 2-max Seat #1 is the button
Seat 1: fightingnuns ($1120.65 in chips) 
Seat 2: otvar132 ($199 in chips) 
fightingnuns: posts small blind $2
otvar132: posts big blind $4
*** HOLE CARDS ***
Dealt to fightingnuns [Jh Qd]
fightingnuns: raises $8 to $12
otvar132: raises $8 to $20
fightingnuns: calls $8
*** FLOP *** [Ad 6s 8h]
otvar132: bets $4
fightingnuns: folds 
Uncalled bet ($4) returned to otvar132
otvar132 collected $39.50 from pot
otvar132: doesn't show hand 
*** SUMMARY ***
Total pot $40 | Rake $0.50 
Board [Ad 6s 8h]
Seat 1: fightingnuns (button) (small blind) folded on the Flop
Seat 2: otvar132 (big blind) collected ($39.50)



PokerStars Game #59917756078:  Hold'em No Limit ($2/$4 USD) - 2011/03/27 19:22:19 ET
Table 'Pulcherrima XI' 2-max Seat #2 is the button
Seat 1: fightingnuns ($1100.65 in chips) 
Seat 2: otvar132 ($218.50 in chips) 
otvar132: posts small blind $2
fightingnuns: posts big blind $4
*** HOLE CARDS ***
Dealt to fightingnuns [6d 5s]
otvar132: calls $2
fightingnuns: checks 
*** FLOP *** [7d 7c 4s]
fightingnuns: bets $8
otvar132: folds 
Uncalled bet ($8) returned to fightingnuns
fightingnuns collected $7.60 from pot
fightingnuns: doesn't show hand 
*** SUMMARY ***
Total pot $8 | Rake $0.40 
Board [7d 7c 4s]
Seat 1: fightingnuns (big blind) collected ($7.60)
Seat 2: otvar132 (button) (small blind) folded on the Flop



PokerStars Game #59917768435:  Hold'em No Limit ($2/$4 USD) - 2011/03/27 19:22:33 ET
Table 'Pulcherrima XI' 2-max Seat #1 is the button
Seat 1: fightingnuns ($1104.25 in chips) 
Seat 2: otvar132 ($214.50 in chips) 
fightingnuns: posts small blind $2
otvar132: posts big blind $4
*** HOLE CARDS ***
Dealt to fightingnuns [5h 2d]
fightingnuns: folds 
Uncalled bet ($2) returned to otvar132
otvar132 collected $4 from pot
otvar132: doesn't show hand 
*** SUMMARY ***
Total pot $4 | Rake $0 
Seat 1: fightingnuns (button) (small blind) folded before Flop
Seat 2: otvar132 (big blind) collected ($4)



PokerStars Game #59917773173:  Hold'em No Limit ($2/$4 USD) - 2011/03/27 19:22:38 ET
Table 'Pulcherrima XI' 2-max Seat #2 is the button
Seat 1: fightingnuns ($1102.25 in chips) 
Seat 2: otvar132 ($216.50 in chips) 
otvar132: posts small blind $2
fightingnuns: posts big blind $4
*** HOLE CARDS ***
Dealt to fightingnuns [Qh 6c]
otvar132: calls $2
fightingnuns: checks 
*** FLOP *** [Jc Td 8c]
fightingnuns: checks 
otvar132: checks 
*** TURN *** [Jc Td 8c] [Ks]
fightingnuns: checks 
otvar132: bets $8
fightingnuns: folds 
Uncalled bet ($8) returned to otvar132
otvar132 collected $7.60 from pot
otvar132: doesn't show hand 
*** SUMMARY ***
Total pot $8 | Rake $0.40 
Board [Jc Td 8c Ks]
Seat 1: fightingnuns (big blind) folded on the Turn
Seat 2: otvar132 (button) (small blind) collected ($7.60)



PokerStars Game #59917785835:  Hold'em No Limit ($2/$4 USD) - 2011/03/27 19:22:52 ET
Table 'Pulcherrima XI' 2-max Seat #1 is the button
Seat 1: fightingnuns ($1098.25 in chips) 
Seat 2: otvar132 ($220.10 in chips) 
fightingnuns: posts small blind $2
otvar132: posts big blind $4
*** HOLE CARDS ***
Dealt to fightingnuns [6h 9h]
fightingnuns: raises $8 to $12
otvar132: raises $8 to $20
fightingnuns: calls $8
*** FLOP *** [Ac Kc 6c]
otvar132: bets $16
fightingnuns: folds 
Uncalled bet ($16) returned to otvar132
otvar132 collected $39.50 from pot
otvar132: doesn't show hand 
*** SUMMARY ***
Total pot $40 | Rake $0.50 
Board [Ac Kc 6c]
Seat 1: fightingnuns (button) (small blind) folded on the Flop
Seat 2: otvar132 (big blind) collected ($39.50)



PokerStars Game #59917799559:  Hold'em No Limit ($2/$4 USD) - 2011/03/27 19:23:08 ET
Table 'Pulcherrima XI' 2-max Seat #2 is the button
Seat 1: fightingnuns ($1078.25 in chips) 
Seat 2: otvar132 ($239.60 in chips) 
otvar132: posts small blind $2
fightingnuns: posts big blind $4
*** HOLE CARDS ***
Dealt to fightingnuns [8h 5h]
otvar132: calls $2
fightingnuns: checks 
*** FLOP *** [Kd 9s 3s]
fightingnuns: checks 
otvar132: checks 
*** TURN *** [Kd 9s 3s] [3h]
fightingnuns: bets $8
otvar132: calls $8
*** RIVER *** [Kd 9s 3s 3h] [7d]
fightingnuns: checks 
otvar132: checks 
*** SHOW DOWN ***
fightingnuns: shows [8h 5h] (a pair of Threes)
otvar132: shows [Ks 4h] (two pair, Kings and Threes)
otvar132 collected $23.50 from pot
*** SUMMARY ***
Total pot $24 | Rake $0.50 
Board [Kd 9s 3s 3h 7d]
Seat 1: fightingnuns (big blind) showed [8h 5h] and lost with a pair of Threes
Seat 2: otvar132 (button) (small blind) showed [Ks 4h] and won ($23.50) with two pair, Kings and Threes



PokerStars Game #59917815436:  Hold'em No Limit ($2/$4 USD) - 2011/03/27 19:23:26 ET
Table 'Pulcherrima XI' 2-max Seat #1 is the button
Seat 1: fightingnuns ($1066.25 in chips) 
Seat 2: otvar132 ($251.10 in chips) 
fightingnuns: posts small blind $2
otvar132: posts big blind $4
*** HOLE CARDS ***
Dealt to fightingnuns [9c Kd]
fightingnuns: raises $8 to $12
otvar132: raises $8 to $20
fightingnuns: calls $8
*** FLOP *** [9h 5c 3h]
otvar132: checks 
fightingnuns: bets $24
otvar132: calls $24
*** TURN *** [9h 5c 3h] [6h]
otvar132: checks 
fightingnuns: bets $68
otvar132: folds 
Uncalled bet ($68) returned to fightingnuns
fightingnuns collected $87.50 from pot
fightingnuns: doesn't show hand 
*** SUMMARY ***
Total pot $88 | Rake $0.50 
Board [9h 5c 3h 6h]
Seat 1: fightingnuns (button) (small blind) collected ($87.50)
Seat 2: otvar132 (big blind) folded on the Turn



PokerStars Game #59917840835:  Hold'em No Limit ($2/$4 USD) - 2011/03/27 19:23:55 ET
Table 'Pulcherrima XI' 2-max Seat #2 is the button
Seat 1: fightingnuns ($1109.75 in chips) 
Seat 2: otvar132 ($207.10 in chips) 
otvar132: posts small blind $2
fightingnuns: posts big blind $4
*** HOLE CARDS ***
Dealt to fightingnuns [8s As]
otvar132: folds 
Uncalled bet ($2) returned to fightingnuns
fightingnuns collected $4 from pot
fightingnuns: doesn't show hand 
*** SUMMARY ***
Total pot $4 | Rake $0 
Seat 1: fightingnuns (big blind) collected ($4)
Seat 2: otvar132 (button) (small blind) folded before Flop



PokerStars Game #59917846888:  Hold'em No Limit ($2/$4 USD) - 2011/03/27 19:24:01 ET
Table 'Pulcherrima XI' 2-max Seat #1 is the button
Seat 1: fightingnuns ($1111.75 in chips) 
Seat 2: otvar132 ($205.10 in chips) 
fightingnuns: posts small blind $2
otvar132: posts big blind $4
*** HOLE CARDS ***
Dealt to fightingnuns [Js 9s]
fightingnuns: raises $8 to $12
otvar132: calls $8
*** FLOP *** [4h 2c Ah]
otvar132: checks 
fightingnuns: checks 
*** TURN *** [4h 2c Ah] [Td]
otvar132: bets $4
fightingnuns: calls $4
*** RIVER *** [4h 2c Ah Td] [7h]
otvar132: bets $4
fightingnuns: calls $4
*** SHOW DOWN ***
otvar132: shows [8d Qs] (high card Ace)
fightingnuns: mucks hand 
otvar132 collected $39.50 from pot
*** SUMMARY ***
Total pot $40 | Rake $0.50 
Board [4h 2c Ah Td 7h]
Seat 1: fightingnuns (button) (small blind) mucked [Js 9s]
Seat 2: otvar132 (big blind) showed [8d Qs] and won ($39.50) with high card Ace



PokerStars Game #59917866320:  Hold'em No Limit ($2/$4 USD) - 2011/03/27 19:24:23 ET
Table 'Pulcherrima XI' 2-max Seat #2 is the button
Seat 1: fightingnuns ($1091.75 in chips) 
Seat 2: otvar132 ($224.60 in chips) 
otvar132: posts small blind $2
fightingnuns: posts big blind $4
*** HOLE CARDS ***
Dealt to fightingnuns [Ah 3d]
otvar132: calls $2
fightingnuns: checks 
*** FLOP *** [5s 9s Kc]
fightingnuns: checks 
otvar132: bets $8
fightingnuns: folds 
Uncalled bet ($8) returned to otvar132
otvar132 collected $7.60 from pot
otvar132: doesn't show hand 
*** SUMMARY ***
Total pot $8 | Rake $0.40 
Board [5s 9s Kc]
Seat 1: fightingnuns (big blind) folded on the Flop
Seat 2: otvar132 (button) (small blind) collected ($7.60)



PokerStars Game #59917876796:  Hold'em No Limit ($2/$4 USD) - 2011/03/27 19:24:35 ET
Table 'Pulcherrima XI' 2-max Seat #1 is the button
Seat 1: fightingnuns ($1087.75 in chips) 
Seat 2: otvar132 ($228.20 in chips) 
fightingnuns: posts small blind $2
otvar132: posts big blind $4
*** HOLE CARDS ***
Dealt to fightingnuns [4c Kh]
fightingnuns: folds 
Uncalled bet ($2) returned to otvar132
otvar132 collected $4 from pot
otvar132: doesn't show hand 
*** SUMMARY ***
Total pot $4 | Rake $0 
Seat 1: fightingnuns (button) (small blind) folded before Flop
Seat 2: otvar132 (big blind) collected ($4)



PokerStars Game #59917882179:  Hold'em No Limit ($2/$4 USD) - 2011/03/27 19:24:41 ET
Table 'Pulcherrima XI' 2-max Seat #2 is the button
Seat 1: fightingnuns ($1085.75 in chips) 
Seat 2: otvar132 ($230.20 in chips) 
otvar132: posts small blind $2
fightingnuns: posts big blind $4
*** HOLE CARDS ***
Dealt to fightingnuns [Ac 2d]
otvar132: calls $2
fightingnuns: checks 
*** FLOP *** [Jc 4h Ad]
fightingnuns: bets $8
otvar132: calls $8
*** TURN *** [Jc 4h Ad] [2h]
fightingnuns: bets $24
otvar132: folds 
Uncalled bet ($24) returned to fightingnuns
fightingnuns collected $23.50 from pot
fightingnuns: doesn't show hand 
*** SUMMARY ***
Total pot $24 | Rake $0.50 
Board [Jc 4h Ad 2h]
Seat 1: fightingnuns (big blind) collected ($23.50)
Seat 2: otvar132 (button) (small blind) folded on the Turn



PokerStars Game #59917897185:  Hold'em No Limit ($2/$4 USD) - 2011/03/27 19:24:59 ET
Table 'Pulcherrima XI' 2-max Seat #1 is the button
Seat 1: fightingnuns ($1097.25 in chips) 
Seat 2: otvar132 ($218.20 in chips) 
fightingnuns: posts small blind $2
otvar132: posts big blind $4
*** HOLE CARDS ***
Dealt to fightingnuns [3c Kc]
fightingnuns: raises $8 to $12
otvar132: calls $8
*** FLOP *** [Jd 6c Qs]
otvar132: checks 
fightingnuns: checks 
*** TURN *** [Jd 6c Qs] [4d]
otvar132: checks 
fightingnuns: bets $16
otvar132: calls $16
*** RIVER *** [Jd 6c Qs 4d] [9h]
otvar132: checks 
fightingnuns: checks 
*** SHOW DOWN ***
otvar132: shows [5s 7d] (high card Queen)
fightingnuns: shows [3c Kc] (high card King)
fightingnuns collected $55.50 from pot
*** SUMMARY ***
Total pot $56 | Rake $0.50 
Board [Jd 6c Qs 4d 9h]
Seat 1: fightingnuns (button) (small blind) showed [3c Kc] and won ($55.50) with high card King
Seat 2: otvar132 (big blind) showed [5s 7d] and lost with high card Queen



PokerStars Game #59917917244:  Hold'em No Limit ($2/$4 USD) - 2011/03/27 19:25:22 ET
Table 'Pulcherrima XI' 2-max Seat #2 is the button
Seat 1: fightingnuns ($1124.75 in chips) 
Seat 2: otvar132 ($190.20 in chips) 
otvar132: posts small blind $2
fightingnuns: posts big blind $4
*** HOLE CARDS ***
Dealt to fightingnuns [Js 3d]
otvar132: folds 
Uncalled bet ($2) returned to fightingnuns
fightingnuns collected $4 from pot
fightingnuns: doesn't show hand 
*** SUMMARY ***
Total pot $4 | Rake $0 
Seat 1: fightingnuns (big blind) collected ($4)
Seat 2: otvar132 (button) (small blind) folded before Flop



PokerStars Game #59917922558:  Hold'em No Limit ($2/$4 USD) - 2011/03/27 19:25:28 ET
Table 'Pulcherrima XI' 2-max Seat #1 is the button
Seat 1: fightingnuns ($1126.75 in chips) 
Seat 2: otvar132 ($188.20 in chips) 
fightingnuns: posts small blind $2
otvar132: posts big blind $4
*** HOLE CARDS ***
Dealt to fightingnuns [Th 8s]
fightingnuns: raises $8 to $12
otvar132: raises $8 to $20
fightingnuns: calls $8
*** FLOP *** [Qs Jh Qh]
otvar132: checks 
fightingnuns: checks 
*** TURN *** [Qs Jh Qh] [Js]
otvar132: checks 
fightingnuns: checks 
*** RIVER *** [Qs Jh Qh Js] [3h]
otvar132: bets $32
fightingnuns: folds 
Uncalled bet ($32) returned to otvar132
otvar132 collected $39.50 from pot
otvar132: doesn't show hand 
*** SUMMARY ***
Total pot $40 | Rake $0.50 
Board [Qs Jh Qh Js 3h]
Seat 1: fightingnuns (button) (small blind) folded on the River
Seat 2: otvar132 (big blind) collected ($39.50)



PokerStars Game #59917945655:  Hold'em No Limit ($2/$4 USD) - 2011/03/27 19:25:54 ET
Table 'Pulcherrima XI' 2-max Seat #2 is the button
Seat 1: fightingnuns ($1106.75 in chips) 
Seat 2: otvar132 ($207.70 in chips) 
otvar132: posts small blind $2
fightingnuns: posts big blind $4
*** HOLE CARDS ***
Dealt to fightingnuns [Qc 5d]
otvar132: raises $8 to $12
fightingnuns: folds 
Uncalled bet ($8) returned to otvar132
otvar132 collected $8 from pot
otvar132: doesn't show hand 
*** SUMMARY ***
Total pot $8 | Rake $0 
Seat 1: fightingnuns (big blind) folded before Flop
Seat 2: otvar132 (button) (small blind) collected ($8)



PokerStars Game #59917952104:  Hold'em No Limit ($2/$4 USD) - 2011/03/27 19:26:02 ET
Table 'Pulcherrima XI' 2-max Seat #1 is the button
Seat 1: fightingnuns ($1102.75 in chips) 
Seat 2: otvar132 ($211.70 in chips) 
fightingnuns: posts small blind $2
otvar132: posts big blind $4
*** HOLE CARDS ***
Dealt to fightingnuns [8h 6s]
fightingnuns: raises $8 to $12
otvar132: raises $20 to $32
fightingnuns: folds 
Uncalled bet ($20) returned to otvar132
otvar132 collected $24 from pot
otvar132: doesn't show hand 
*** SUMMARY ***
Total pot $24 | Rake $0 
Seat 1: fightingnuns (button) (small blind) folded before Flop
Seat 2: otvar132 (big blind) collected ($24)



PokerStars Game #59917961385:  Hold'em No Limit ($2/$4 USD) - 2011/03/27 19:26:12 ET
Table 'Pulcherrima XI' 2-max Seat #2 is the button
Seat 1: fightingnuns ($1090.75 in chips) 
Seat 2: otvar132 ($223.70 in chips) 
otvar132: posts small blind $2
fightingnuns: posts big blind $4
*** HOLE CARDS ***
Dealt to fightingnuns [Qd 9s]
otvar132: folds 
Uncalled bet ($2) returned to fightingnuns
fightingnuns collected $4 from pot
fightingnuns: doesn't show hand 
*** SUMMARY ***
Total pot $4 | Rake $0 
Seat 1: fightingnuns (big blind) collected ($4)
Seat 2: otvar132 (button) (small blind) folded before Flop



PokerStars Game #59917966769:  Hold'em No Limit ($2/$4 USD) - 2011/03/27 19:26:18 ET
Table 'Pulcherrima XI' 2-max Seat #1 is the button
Seat 1: fightingnuns ($1092.75 in chips) 
Seat 2: otvar132 ($221.70 in chips) 
fightingnuns: posts small blind $2
otvar132: posts big blind $4
*** HOLE CARDS ***
Dealt to fightingnuns [2s 3d]
fightingnuns: folds 
Uncalled bet ($2) returned to otvar132
otvar132 collected $4 from pot
*** SUMMARY ***
Total pot $4 | Rake $0 
Seat 1: fightingnuns (button) (small blind) folded before Flop
Seat 2: otvar132 (big blind) collected ($4)



PokerStars Game #59917971387:  Hold'em No Limit ($2/$4 USD) - 2011/03/27 19:26:24 ET
Table 'Pulcherrima XI' 2-max Seat #2 is the button
Seat 1: fightingnuns ($1090.75 in chips) 
Seat 2: otvar132 ($223.70 in chips) 
otvar132: posts small blind $2
fightingnuns: posts big blind $4
*** HOLE CARDS ***
Dealt to fightingnuns [9d 6h]
otvar132: calls $2
fightingnuns: checks 
*** FLOP *** [6d 3s Qh]
fightingnuns: checks 
otvar132: bets $8
fightingnuns: calls $8
*** TURN *** [6d 3s Qh] [7d]
fightingnuns: checks 
otvar132: checks 
*** RIVER *** [6d 3s Qh 7d] [Qd]
fightingnuns: bets $16
otvar132: folds 
Uncalled bet ($16) returned to fightingnuns
fightingnuns collected $23.50 from pot
fightingnuns: doesn't show hand 
*** SUMMARY ***
Total pot $24 | Rake $0.50 
Board [6d 3s Qh 7d Qd]
Seat 1: fightingnuns (big blind) collected ($23.50)
Seat 2: otvar132 (button) (small blind) folded on the River



PokerStars Game #59917988706:  Hold'em No Limit ($2/$4 USD) - 2011/03/27 19:26:43 ET
Table 'Pulcherrima XI' 2-max Seat #1 is the button
Seat 1: fightingnuns ($1102.25 in chips) 
Seat 2: otvar132 ($211.70 in chips) 
fightingnuns: posts small blind $2
otvar132: posts big blind $4
*** HOLE CARDS ***
Dealt to fightingnuns [Qh 3d]
fightingnuns: folds 
Uncalled bet ($2) returned to otvar132
otvar132 collected $4 from pot
otvar132: doesn't show hand 
*** SUMMARY ***
Total pot $4 | Rake $0 
Seat 1: fightingnuns (button) (small blind) folded before Flop
Seat 2: otvar132 (big blind) collected ($4)



PokerStars Game #59917993277:  Hold'em No Limit ($2/$4 USD) - 2011/03/27 19:26:49 ET
Table 'Pulcherrima XI' 2-max Seat #2 is the button
Seat 1: fightingnuns ($1100.25 in chips) 
Seat 2: otvar132 ($213.70 in chips) 
otvar132: posts small blind $2
fightingnuns: posts big blind $4
*** HOLE CARDS ***
Dealt to fightingnuns [Kc 6s]
otvar132: folds 
Uncalled bet ($2) returned to fightingnuns
fightingnuns collected $4 from pot
fightingnuns: doesn't show hand 
*** SUMMARY ***
Total pot $4 | Rake $0 
Seat 1: fightingnuns (big blind) collected ($4)
Seat 2: otvar132 (button) (small blind) folded before Flop



PokerStars Game #59917998645:  Hold'em No Limit ($2/$4 USD) - 2011/03/27 19:26:55 ET
Table 'Pulcherrima XI' 2-max Seat #1 is the button
Seat 1: fightingnuns ($1102.25 in chips) 
Seat 2: otvar132 ($211.70 in chips) 
fightingnuns: posts small blind $2
otvar132: posts big blind $4
*** HOLE CARDS ***
Dealt to fightingnuns [Jd 7c]
fightingnuns: raises $8 to $12
otvar132: raises $8 to $20
fightingnuns: calls $8
*** FLOP *** [6h As 3h]
otvar132: bets $4
fightingnuns: raises $20 to $24
otvar132: raises $20 to $44
fightingnuns: folds 
Uncalled bet ($20) returned to otvar132
otvar132 collected $87.50 from pot
otvar132: doesn't show hand 
*** SUMMARY ***
Total pot $88 | Rake $0.50 
Board [6h As 3h]
Seat 1: fightingnuns (button) (small blind) folded on the Flop
Seat 2: otvar132 (big blind) collected ($87.50)



PokerStars Game #59918020961:  Hold'em No Limit ($2/$4 USD) - 2011/03/27 19:27:21 ET
Table 'Pulcherrima XI' 2-max Seat #2 is the button
Seat 1: fightingnuns ($1058.25 in chips) 
Seat 2: otvar132 ($255.20 in chips) 
otvar132: posts small blind $2
fightingnuns: posts big blind $4
*** HOLE CARDS ***
Dealt to fightingnuns [4s Tc]
otvar132: calls $2
fightingnuns: checks 
*** FLOP *** [3d 6d Qd]
fightingnuns: checks 
otvar132: bets $4
fightingnuns: folds 
Uncalled bet ($4) returned to otvar132
otvar132 collected $7.60 from pot
otvar132: doesn't show hand 
*** SUMMARY ***
Total pot $8 | Rake $0.40 
Board [3d 6d Qd]
Seat 1: fightingnuns (big blind) folded on the Flop
Seat 2: otvar132 (button) (small blind) collected ($7.60)



PokerStars Game #59918033217:  Hold'em No Limit ($2/$4 USD) - 2011/03/27 19:27:34 ET
Table 'Pulcherrima XI' 2-max Seat #1 is the button
Seat 1: fightingnuns ($1054.25 in chips) 
Seat 2: otvar132 ($258.80 in chips) 
fightingnuns: posts small blind $2
otvar132: posts big blind $4
*** HOLE CARDS ***
Dealt to fightingnuns [7h 7s]
fightingnuns: raises $8 to $12
otvar132: calls $8
*** FLOP *** [Js 4h Kh]
otvar132: checks 
fightingnuns: checks 
*** TURN *** [Js 4h Kh] [3h]
otvar132: checks 
fightingnuns: bets $16
otvar132: folds 
Uncalled bet ($16) returned to fightingnuns
fightingnuns collected $23.50 from pot
fightingnuns: doesn't show hand 
*** SUMMARY ***
Total pot $24 | Rake $0.50 
Board [Js 4h Kh 3h]
Seat 1: fightingnuns (button) (small blind) collected ($23.50)
Seat 2: otvar132 (big blind) folded on the Turn



PokerStars Game #59918050869:  Hold'em No Limit ($2/$4 USD) - 2011/03/27 19:27:55 ET
Table 'Pulcherrima XI' 2-max Seat #2 is the button
Seat 1: fightingnuns ($1065.75 in chips) 
Seat 2: otvar132 ($246.80 in chips) 
otvar132: posts small blind $2
fightingnuns: posts big blind $4
*** HOLE CARDS ***
Dealt to fightingnuns [8s 2s]
otvar132: calls $2
fightingnuns: checks 
*** FLOP *** [6s Th Kh]
fightingnuns: checks 
otvar132: checks 
*** TURN *** [6s Th Kh] [4h]
fightingnuns: checks 
otvar132: bets $8
fightingnuns: folds 
Uncalled bet ($8) returned to otvar132
otvar132 collected $7.60 from pot
otvar132: doesn't show hand 
*** SUMMARY ***
Total pot $8 | Rake $0.40 
Board [6s Th Kh 4h]
Seat 1: fightingnuns (big blind) folded on the Turn
Seat 2: otvar132 (button) (small blind) collected ($7.60)



PokerStars Game #59918063602:  Hold'em No Limit ($2/$4 USD) - 2011/03/27 19:28:10 ET
Table 'Pulcherrima XI' 2-max Seat #1 is the button
Seat 1: fightingnuns ($1061.75 in chips) 
Seat 2: otvar132 ($250.40 in chips) 
fightingnuns: posts small blind $2
otvar132: posts big blind $4
*** HOLE CARDS ***
Dealt to fightingnuns [Jc 5s]
fightingnuns: folds 
Uncalled bet ($2) returned to otvar132
otvar132 collected $4 from pot
otvar132: doesn't show hand 
*** SUMMARY ***
Total pot $4 | Rake $0 
Seat 1: fightingnuns (button) (small blind) folded before Flop
Seat 2: otvar132 (big blind) collected ($4)



PokerStars Game #59918068578:  Hold'em No Limit ($2/$4 USD) - 2011/03/27 19:28:16 ET
Table 'Pulcherrima XI' 2-max Seat #2 is the button
Seat 1: fightingnuns ($1059.75 in chips) 
Seat 2: otvar132 ($252.40 in chips) 
otvar132: posts small blind $2
fightingnuns: posts big blind $4
*** HOLE CARDS ***
Dealt to fightingnuns [4s Kh]
otvar132: calls $2
fightingnuns: checks 
*** FLOP *** [8h 6s 5h]
fightingnuns: checks 
otvar132: checks 
*** TURN *** [8h 6s 5h] [3h]
fightingnuns: bets $8
otvar132: calls $8
*** RIVER *** [8h 6s 5h 3h] [4h]
fightingnuns: checks 
otvar132: bets $16
fightingnuns: raises $52 to $68
otvar132: calls $52
*** SHOW DOWN ***
fightingnuns: shows [4s Kh] (a flush, King high)
otvar132: mucks hand 
fightingnuns collected $159.50 from pot
*** SUMMARY ***
Total pot $160 | Rake $0.50 
Board [8h 6s 5h 3h 4h]
Seat 1: fightingnuns (big blind) showed [4s Kh] and won ($159.50) with a flush, King high
Seat 2: otvar132 (button) (small blind) mucked [Th As]



PokerStars Game #59918094862:  Hold'em No Limit ($2/$4 USD) - 2011/03/27 19:28:46 ET
Table 'Pulcherrima XI' 2-max Seat #1 is the button
Seat 1: fightingnuns ($1139.25 in chips) 
Seat 2: otvar132 ($172.40 in chips) 
fightingnuns: posts small blind $2
otvar132: posts big blind $4
*** HOLE CARDS ***
Dealt to fightingnuns [2d Td]
fightingnuns: raises $8 to $12
otvar132: calls $8
*** FLOP *** [Ad Kh 8s]
otvar132: checks 
fightingnuns: checks 
*** TURN *** [Ad Kh 8s] [9c]
otvar132: checks 
fightingnuns: checks 
*** RIVER *** [Ad Kh 8s 9c] [Ts]
otvar132: checks 
fightingnuns: bets $12
otvar132: folds 
Uncalled bet ($12) returned to fightingnuns
fightingnuns collected $23.50 from pot
fightingnuns: doesn't show hand 
*** SUMMARY ***
Total pot $24 | Rake $0.50 
Board [Ad Kh 8s 9c Ts]
Seat 1: fightingnuns (button) (small blind) collected ($23.50)
Seat 2: otvar132 (big blind) folded on the River



PokerStars Game #59918118291:  Hold'em No Limit ($2/$4 USD) - 2011/03/27 19:29:13 ET
Table 'Pulcherrima XI' 2-max Seat #2 is the button
Seat 1: fightingnuns ($1150.75 in chips) 
Seat 2: otvar132 ($160.40 in chips) 
otvar132: posts small blind $2
fightingnuns: posts big blind $4
*** HOLE CARDS ***
Dealt to fightingnuns [Kc 7d]
otvar132: calls $2
fightingnuns: checks 
*** FLOP *** [As Th Qh]
fightingnuns: checks 
otvar132: checks 
*** TURN *** [As Th Qh] [9d]
fightingnuns: checks 
otvar132: bets $8
fightingnuns: folds 
Uncalled bet ($8) returned to otvar132
otvar132 collected $7.60 from pot
otvar132: doesn't show hand 
*** SUMMARY ***
Total pot $8 | Rake $0.40 
Board [As Th Qh 9d]
Seat 1: fightingnuns (big blind) folded on the Turn
Seat 2: otvar132 (button) (small blind) collected ($7.60)



PokerStars Game #59918132162:  Hold'em No Limit ($2/$4 USD) - 2011/03/27 19:29:29 ET
Table 'Pulcherrima XI' 2-max Seat #1 is the button
Seat 1: fightingnuns ($1146.75 in chips) 
Seat 2: otvar132 ($164 in chips) 
fightingnuns: posts small blind $2
otvar132: posts big blind $4
*** HOLE CARDS ***
Dealt to fightingnuns [Kh 2s]
fightingnuns: folds 
Uncalled bet ($2) returned to otvar132
otvar132 collected $4 from pot
otvar132: doesn't show hand 
*** SUMMARY ***
Total pot $4 | Rake $0 
Seat 1: fightingnuns (button) (small blind) folded before Flop
Seat 2: otvar132 (big blind) collected ($4)



PokerStars Game #59918137180:  Hold'em No Limit ($2/$4 USD) - 2011/03/27 19:29:35 ET
Table 'Pulcherrima XI' 2-max Seat #2 is the button
Seat 1: fightingnuns ($1144.75 in chips) 
Seat 2: otvar132 ($166 in chips) 
otvar132: posts small blind $2
fightingnuns: posts big blind $4
*** HOLE CARDS ***
Dealt to fightingnuns [5c Th]
otvar132: folds 
Uncalled bet ($2) returned to fightingnuns
fightingnuns collected $4 from pot
fightingnuns: doesn't show hand 
*** SUMMARY ***
Total pot $4 | Rake $0 
Seat 1: fightingnuns (big blind) collected ($4)
Seat 2: otvar132 (button) (small blind) folded before Flop



PokerStars Game #59918142614:  Hold'em No Limit ($2/$4 USD) - 2011/03/27 19:29:41 ET
Table 'Pulcherrima XI' 2-max Seat #1 is the button
Seat 1: fightingnuns ($1146.75 in chips) 
Seat 2: otvar132 ($164 in chips) 
fightingnuns: posts small blind $2
otvar132: posts big blind $4
*** HOLE CARDS ***
Dealt to fightingnuns [4c 9h]
fightingnuns: folds 
Uncalled bet ($2) returned to otvar132
otvar132 collected $4 from pot
*** SUMMARY ***
Total pot $4 | Rake $0 
Seat 1: fightingnuns (button) (small blind) folded before Flop
Seat 2: otvar132 (big blind) collected ($4)



PokerStars Game #59918147624:  Hold'em No Limit ($2/$4 USD) - 2011/03/27 19:29:47 ET
Table 'Pulcherrima XI' 2-max Seat #2 is the button
Seat 1: fightingnuns ($1144.75 in chips) 
Seat 2: otvar132 ($166 in chips) 
otvar132: posts small blind $2
fightingnuns: posts big blind $4
*** HOLE CARDS ***
Dealt to fightingnuns [4h 5d]
otvar132: calls $2
fightingnuns: checks 
*** FLOP *** [Th 4s 9h]
fightingnuns: checks 
otvar132: checks 
*** TURN *** [Th 4s 9h] [Ts]
fightingnuns: checks 
otvar132: bets $4
fightingnuns: calls $4
*** RIVER *** [Th 4s 9h Ts] [Qh]
fightingnuns: checks 
otvar132: bets $8
fightingnuns: folds 
Uncalled bet ($8) returned to otvar132
otvar132 collected $15.50 from pot
otvar132: doesn't show hand 
*** SUMMARY ***
Total pot $16 | Rake $0.50 
Board [Th 4s 9h Ts Qh]
Seat 1: fightingnuns (big blind) folded on the River
Seat 2: otvar132 (button) (small blind) collected ($15.50)



PokerStars Game #59918166133:  Hold'em No Limit ($2/$4 USD) - 2011/03/27 19:30:08 ET
Table 'Pulcherrima XI' 2-max Seat #1 is the button
Seat 1: fightingnuns ($1136.75 in chips) 
Seat 2: otvar132 ($173.50 in chips) 
fightingnuns: posts small blind $2
otvar132: posts big blind $4
*** HOLE CARDS ***
Dealt to fightingnuns [Qh Ah]
fightingnuns: raises $8 to $12
otvar132: calls $8
*** FLOP *** [8h Td 5h]
otvar132: checks 
fightingnuns: bets $16
otvar132: calls $16
*** TURN *** [8h Td 5h] [As]
otvar132: checks 
fightingnuns: bets $40
otvar132: raises $105.50 to $145.50 and is all-in
fightingnuns: calls $105.50
*** RIVER *** [8h Td 5h As] [Th]
*** SHOW DOWN ***
otvar132: shows [Kd Ac] (two pair, Aces and Tens)
fightingnuns: shows [Qh Ah] (a flush, Ace high)
fightingnuns collected $346.50 from pot
*** SUMMARY ***
Total pot $347 | Rake $0.50 
Board [8h Td 5h As Th]
Seat 1: fightingnuns (button) (small blind) showed [Qh Ah] and won ($346.50) with a flush, Ace high
Seat 2: otvar132 (big blind) showed [Kd Ac] and lost with two pair, Aces and Tens



PokerStars Game #59892522238:  Hold'em No Limit ($3/$6 USD) - 2011/03/27 13:04:56 ET
Table 'Lexell XI' 2-max Seat #2 is the button
Seat 1: fightingnuns ($600 in chips) 
Seat 2: mascom ($600 in chips) 
mascom: posts small blind $3
fightingnuns: posts big blind $6
*** HOLE CARDS ***
Dealt to fightingnuns [6h 4s]
mascom: folds 
Uncalled bet ($3) returned to fightingnuns
fightingnuns collected $6 from pot
fightingnuns: doesn't show hand 
*** SUMMARY ***
Total pot $6 | Rake $0 
Seat 1: fightingnuns (big blind) collected ($6)
Seat 2: mascom (button) (small blind) folded before Flop



PokerStars Game #59892532507:  Hold'em No Limit ($3/$6 USD) - 2011/03/27 13:05:06 ET
Table 'Lexell XI' 2-max Seat #1 is the button
Seat 1: fightingnuns ($603 in chips) 
Seat 2: mascom ($597 in chips) 
fightingnuns: posts small blind $3
mascom: posts big blind $6
*** HOLE CARDS ***
Dealt to fightingnuns [8s Tc]
fightingnuns: raises $6 to $12
mascom: folds 
Uncalled bet ($6) returned to fightingnuns
fightingnuns collected $12 from pot
fightingnuns: doesn't show hand 
*** SUMMARY ***
Total pot $12 | Rake $0 
Seat 1: fightingnuns (button) (small blind) collected ($12)
Seat 2: mascom (big blind) folded before Flop



PokerStars Game #59892544601:  Hold'em No Limit ($3/$6 USD) - 2011/03/27 13:05:18 ET
Table 'Lexell XI' 2-max Seat #2 is the button
Seat 1: fightingnuns ($609 in chips) 
Seat 2: mascom ($591 in chips) 
mascom: posts small blind $3
fightingnuns: posts big blind $6
*** HOLE CARDS ***
Dealt to fightingnuns [9d Ks]
mascom: raises $6 to $12
fightingnuns: calls $6
*** FLOP *** [2c 4s 5s]
fightingnuns: checks 
mascom: bets $12
fightingnuns: calls $12
*** TURN *** [2c 4s 5s] [Js]
fightingnuns: checks 
mascom: bets $40
fightingnuns: raises $92 to $132
mascom: calls $92
*** RIVER *** [2c 4s 5s Js] [7d]
fightingnuns: bets $220
mascom: calls $220
*** SHOW DOWN ***
fightingnuns: shows [9d Ks] (high card King)
mascom: shows [3c Ac] (a straight, Ace to Five)
mascom collected $751.50 from pot
*** SUMMARY ***
Total pot $752 | Rake $0.50 
Board [2c 4s 5s Js 7d]
Seat 1: fightingnuns (big blind) showed [9d Ks] and lost with high card King
Seat 2: mascom (button) (small blind) showed [3c Ac] and won ($751.50) with a straight, Ace to Five



PokerStars Game #59892587386:  Hold'em No Limit ($3/$6 USD) - 2011/03/27 13:05:58 ET
Table 'Lexell XI' 2-max Seat #1 is the button
Seat 1: fightingnuns ($600 in chips) 
Seat 2: mascom ($966.50 in chips) 
fightingnuns: posts small blind $3
mascom: posts big blind $6
*** HOLE CARDS ***
Dealt to fightingnuns [Kh 2d]
fightingnuns: folds 
Uncalled bet ($3) returned to mascom
mascom collected $6 from pot
*** SUMMARY ***
Total pot $6 | Rake $0 
Seat 1: fightingnuns (button) (small blind) folded before Flop
Seat 2: mascom (big blind) collected ($6)



PokerStars Game #59892594203:  Hold'em No Limit ($3/$6 USD) - 2011/03/27 13:06:05 ET
Table 'Lexell XI' 2-max Seat #2 is the button
Seat 1: fightingnuns ($600 in chips) 
Seat 2: mascom ($969.50 in chips) 
mascom: posts small blind $3
fightingnuns: posts big blind $6
*** HOLE CARDS ***
Dealt to fightingnuns [8h 2c]
mascom: raises $6 to $12
fightingnuns: folds 
Uncalled bet ($6) returned to mascom
mascom collected $12 from pot
*** SUMMARY ***
Total pot $12 | Rake $0 
Seat 1: fightingnuns (big blind) folded before Flop
Seat 2: mascom (button) (small blind) collected ($12)



PokerStars Game #59892604770:  Hold'em No Limit ($3/$6 USD) - 2011/03/27 13:06:15 ET
Table 'Lexell XI' 2-max Seat #1 is the button
Seat 1: fightingnuns ($600 in chips) 
Seat 2: mascom ($975.50 in chips) 
fightingnuns: posts small blind $3
mascom: posts big blind $6
*** HOLE CARDS ***
Dealt to fightingnuns [Js 4s]
fightingnuns: raises $6 to $12
mascom: calls $6
*** FLOP *** [5s 3h Ts]
mascom: checks 
fightingnuns: bets $18
mascom: folds 
Uncalled bet ($18) returned to fightingnuns
fightingnuns collected $23.50 from pot
fightingnuns: doesn't show hand 
*** SUMMARY ***
Total pot $24 | Rake $0.50 
Board [5s 3h Ts]
Seat 1: fightingnuns (button) (small blind) collected ($23.50)
Seat 2: mascom (big blind) folded on the Flop



PokerStars Game #59892624870:  Hold'em No Limit ($3/$6 USD) - 2011/03/27 13:06:34 ET
Table 'Lexell XI' 2-max Seat #2 is the button
Seat 1: fightingnuns ($611.50 in chips) 
Seat 2: mascom ($963.50 in chips) 
mascom: posts small blind $3
fightingnuns: posts big blind $6
*** HOLE CARDS ***
Dealt to fightingnuns [4h Td]
mascom: raises $6 to $12
fightingnuns: folds 
Uncalled bet ($6) returned to mascom
mascom collected $12 from pot
*** SUMMARY ***
Total pot $12 | Rake $0 
Seat 1: fightingnuns (big blind) folded before Flop
Seat 2: mascom (button) (small blind) collected ($12)



PokerStars Game #59892636247:  Hold'em No Limit ($3/$6 USD) - 2011/03/27 13:06:45 ET
Table 'Lexell XI' 2-max Seat #1 is the button
Seat 1: fightingnuns ($605.50 in chips) 
Seat 2: mascom ($969.50 in chips) 
fightingnuns: posts small blind $3
mascom: posts big blind $6
*** HOLE CARDS ***
Dealt to fightingnuns [4s 5s]
fightingnuns: raises $6 to $12
mascom: folds 
Uncalled bet ($6) returned to fightingnuns
fightingnuns collected $12 from pot
fightingnuns: doesn't show hand 
*** SUMMARY ***
Total pot $12 | Rake $0 
Seat 1: fightingnuns (button) (small blind) collected ($12)
Seat 2: mascom (big blind) folded before Flop



PokerStars Game #59892643527:  Hold'em No Limit ($3/$6 USD) - 2011/03/27 13:06:52 ET
Table 'Lexell XI' 2-max Seat #2 is the button
Seat 1: fightingnuns ($611.50 in chips) 
Seat 2: mascom ($963.50 in chips) 
mascom: posts small blind $3
fightingnuns: posts big blind $6
*** HOLE CARDS ***
Dealt to fightingnuns [9c Kh]
mascom: folds 
Uncalled bet ($3) returned to fightingnuns
fightingnuns collected $6 from pot
fightingnuns: doesn't show hand 
*** SUMMARY ***
Total pot $6 | Rake $0 
Seat 1: fightingnuns (big blind) collected ($6)
Seat 2: mascom (button) (small blind) folded before Flop



PokerStars Game #59892650979:  Hold'em No Limit ($3/$6 USD) - 2011/03/27 13:06:59 ET
Table 'Lexell XI' 2-max Seat #1 is the button
Seat 1: fightingnuns ($614.50 in chips) 
Seat 2: mascom ($960.50 in chips) 
fightingnuns: posts small blind $3
mascom: posts big blind $6
*** HOLE CARDS ***
Dealt to fightingnuns [Ad Ks]
fightingnuns: raises $6 to $12
mascom: folds 
Uncalled bet ($6) returned to fightingnuns
fightingnuns collected $12 from pot
fightingnuns: doesn't show hand 
*** SUMMARY ***
Total pot $12 | Rake $0 
Seat 1: fightingnuns (button) (small blind) collected ($12)
Seat 2: mascom (big blind) folded before Flop



PokerStars Game #59892661271:  Hold'em No Limit ($3/$6 USD) - 2011/03/27 13:07:09 ET
Table 'Lexell XI' 2-max Seat #2 is the button
Seat 1: fightingnuns ($620.50 in chips) 
Seat 2: mascom ($954.50 in chips) 
mascom: posts small blind $3
fightingnuns: posts big blind $6
*** HOLE CARDS ***
Dealt to fightingnuns [Kc Td]
mascom: raises $6 to $12
fightingnuns: raises $24 to $36
mascom: folds 
Uncalled bet ($24) returned to fightingnuns
fightingnuns collected $24 from pot
fightingnuns: doesn't show hand 
*** SUMMARY ***
Total pot $24 | Rake $0 
Seat 1: fightingnuns (big blind) collected ($24)
Seat 2: mascom (button) (small blind) folded before Flop



PokerStars Game #59892677517:  Hold'em No Limit ($3/$6 USD) - 2011/03/27 13:07:25 ET
Table 'Lexell XI' 2-max Seat #1 is the button
Seat 1: fightingnuns ($632.50 in chips) 
Seat 2: mascom ($942.50 in chips) 
fightingnuns: posts small blind $3
mascom: posts big blind $6
*** HOLE CARDS ***
Dealt to fightingnuns [Qh Kd]
fightingnuns: raises $6 to $12
mascom: folds 
Uncalled bet ($6) returned to fightingnuns
fightingnuns collected $12 from pot
fightingnuns: doesn't show hand 
*** SUMMARY ***
Total pot $12 | Rake $0 
Seat 1: fightingnuns (button) (small blind) collected ($12)
Seat 2: mascom (big blind) folded before Flop



PokerStars Game #59892685066:  Hold'em No Limit ($3/$6 USD) - 2011/03/27 13:07:32 ET
Table 'Lexell XI' 2-max Seat #2 is the button
Seat 1: fightingnuns ($638.50 in chips) 
Seat 2: mascom ($936.50 in chips) 
mascom: posts small blind $3
fightingnuns: posts big blind $6
*** HOLE CARDS ***
Dealt to fightingnuns [7c 3h]
mascom: raises $6 to $12
fightingnuns: folds 
Uncalled bet ($6) returned to mascom
mascom collected $12 from pot
*** SUMMARY ***
Total pot $12 | Rake $0 
Seat 1: fightingnuns (big blind) folded before Flop
Seat 2: mascom (button) (small blind) collected ($12)



PokerStars Game #59892698085:  Hold'em No Limit ($3/$6 USD) - 2011/03/27 13:07:45 ET
Table 'Lexell XI' 2-max Seat #1 is the button
Seat 1: fightingnuns ($632.50 in chips) 
Seat 2: mascom ($942.50 in chips) 
fightingnuns: posts small blind $3
mascom: posts big blind $6
*** HOLE CARDS ***
Dealt to fightingnuns [6c 5h]
fightingnuns: raises $6 to $12
mascom: folds 
Uncalled bet ($6) returned to fightingnuns
fightingnuns collected $12 from pot
fightingnuns: doesn't show hand 
*** SUMMARY ***
Total pot $12 | Rake $0 
Seat 1: fightingnuns (button) (small blind) collected ($12)
Seat 2: mascom (big blind) folded before Flop



PokerStars Game #59892708989:  Hold'em No Limit ($3/$6 USD) - 2011/03/27 13:07:55 ET
Table 'Lexell XI' 2-max Seat #2 is the button
Seat 1: fightingnuns ($638.50 in chips) 
Seat 2: mascom ($936.50 in chips) 
mascom: posts small blind $3
fightingnuns: posts big blind $6
*** HOLE CARDS ***
Dealt to fightingnuns [Th Qh]
mascom: folds 
Uncalled bet ($3) returned to fightingnuns
fightingnuns collected $6 from pot
fightingnuns: doesn't show hand 
*** SUMMARY ***
Total pot $6 | Rake $0 
Seat 1: fightingnuns (big blind) collected ($6)
Seat 2: mascom (button) (small blind) folded before Flop



PokerStars Game #59892717543:  Hold'em No Limit ($3/$6 USD) - 2011/03/27 13:08:03 ET
Table 'Lexell XI' 2-max Seat #1 is the button
Seat 1: fightingnuns ($641.50 in chips) 
Seat 2: mascom ($933.50 in chips) 
fightingnuns: posts small blind $3
mascom: posts big blind $6
*** HOLE CARDS ***
Dealt to fightingnuns [3c 5d]
fightingnuns: folds 
Uncalled bet ($3) returned to mascom
mascom collected $6 from pot
*** SUMMARY ***
Total pot $6 | Rake $0 
Seat 1: fightingnuns (button) (small blind) folded before Flop
Seat 2: mascom (big blind) collected ($6)



PokerStars Game #59892725345:  Hold'em No Limit ($3/$6 USD) - 2011/03/27 13:08:11 ET
Table 'Lexell XI' 2-max Seat #2 is the button
Seat 1: fightingnuns ($638.50 in chips) 
Seat 2: mascom ($936.50 in chips) 
mascom: posts small blind $3
fightingnuns: posts big blind $6
*** HOLE CARDS ***
Dealt to fightingnuns [6d 9c]
mascom: raises $6 to $12
fightingnuns: folds 
Uncalled bet ($6) returned to mascom
mascom collected $12 from pot
*** SUMMARY ***
Total pot $12 | Rake $0 
Seat 1: fightingnuns (big blind) folded before Flop
Seat 2: mascom (button) (small blind) collected ($12)



PokerStars Game #59892735873:  Hold'em No Limit ($3/$6 USD) - 2011/03/27 13:08:21 ET
Table 'Lexell XI' 2-max Seat #1 is the button
Seat 1: fightingnuns ($632.50 in chips) 
Seat 2: mascom ($942.50 in chips) 
fightingnuns: posts small blind $3
mascom: posts big blind $6
*** HOLE CARDS ***
Dealt to fightingnuns [2c 7h]
fightingnuns: folds 
Uncalled bet ($3) returned to mascom
mascom collected $6 from pot
*** SUMMARY ***
Total pot $6 | Rake $0 
Seat 1: fightingnuns (button) (small blind) folded before Flop
Seat 2: mascom (big blind) collected ($6)



PokerStars Game #59892742302:  Hold'em No Limit ($3/$6 USD) - 2011/03/27 13:08:27 ET
Table 'Lexell XI' 2-max Seat #2 is the button
Seat 1: fightingnuns ($629.50 in chips) 
Seat 2: mascom ($945.50 in chips) 
mascom: posts small blind $3
fightingnuns: posts big blind $6
*** HOLE CARDS ***
Dealt to fightingnuns [As Th]
mascom: raises $6 to $12
fightingnuns: raises $30 to $42
mascom: folds 
Uncalled bet ($30) returned to fightingnuns
fightingnuns collected $24 from pot
fightingnuns: doesn't show hand 
*** SUMMARY ***
Total pot $24 | Rake $0 
Seat 1: fightingnuns (big blind) collected ($24)
Seat 2: mascom (button) (small blind) folded before Flop



PokerStars Game #59892768980:  Hold'em No Limit ($3/$6 USD) - 2011/03/27 13:08:53 ET
Table 'Lexell XI' 2-max Seat #1 is the button
Seat 1: fightingnuns ($641.50 in chips) 
Seat 2: mascom ($933.50 in chips) 
fightingnuns: posts small blind $3
mascom: posts big blind $6
*** HOLE CARDS ***
Dealt to fightingnuns [7h Jc]
fightingnuns: raises $6 to $12
mascom: folds 
Uncalled bet ($6) returned to fightingnuns
fightingnuns collected $12 from pot
fightingnuns: doesn't show hand 
*** SUMMARY ***
Total pot $12 | Rake $0 
Seat 1: fightingnuns (button) (small blind) collected ($12)
Seat 2: mascom (big blind) folded before Flop



PokerStars Game #59892778215:  Hold'em No Limit ($3/$6 USD) - 2011/03/27 13:09:02 ET
Table 'Lexell XI' 2-max Seat #2 is the button
Seat 1: fightingnuns ($647.50 in chips) 
Seat 2: mascom ($927.50 in chips) 
mascom: posts small blind $3
fightingnuns: posts big blind $6
*** HOLE CARDS ***
Dealt to fightingnuns [9c Kh]
mascom: raises $6 to $12
fightingnuns: calls $6
*** FLOP *** [8s Js 4d]
fightingnuns: checks 
mascom: checks 
*** TURN *** [8s Js 4d] [Ad]
fightingnuns: checks 
mascom: bets $12
fightingnuns: folds 
Uncalled bet ($12) returned to mascom
mascom collected $23.50 from pot
*** SUMMARY ***
Total pot $24 | Rake $0.50 
Board [8s Js 4d Ad]
Seat 1: fightingnuns (big blind) folded on the Turn
Seat 2: mascom (button) (small blind) collected ($23.50)



PokerStars Game #59892805235:  Hold'em No Limit ($3/$6 USD) - 2011/03/27 13:09:28 ET
Table 'Lexell XI' 2-max Seat #1 is the button
Seat 1: fightingnuns ($635.50 in chips) 
Seat 2: mascom ($939 in chips) 
fightingnuns: posts small blind $3
mascom: posts big blind $6
*** HOLE CARDS ***
Dealt to fightingnuns [Qh 4s]
fightingnuns: raises $6 to $12
mascom: calls $6
*** FLOP *** [Ts 2s 6h]
mascom: bets $12
fightingnuns: folds 
Uncalled bet ($12) returned to mascom
mascom collected $23.50 from pot
*** SUMMARY ***
Total pot $24 | Rake $0.50 
Board [Ts 2s 6h]
Seat 1: fightingnuns (button) (small blind) folded on the Flop
Seat 2: mascom (big blind) collected ($23.50)



PokerStars Game #59892826993:  Hold'em No Limit ($3/$6 USD) - 2011/03/27 13:09:49 ET
Table 'Lexell XI' 2-max Seat #2 is the button
Seat 1: fightingnuns ($623.50 in chips) 
Seat 2: mascom ($950.50 in chips) 
mascom: posts small blind $3
fightingnuns: posts big blind $6
*** HOLE CARDS ***
Dealt to fightingnuns [8s 3d]
mascom: raises $6 to $12
fightingnuns: folds 
Uncalled bet ($6) returned to mascom
mascom collected $12 from pot
*** SUMMARY ***
Total pot $12 | Rake $0 
Seat 1: fightingnuns (big blind) folded before Flop
Seat 2: mascom (button) (small blind) collected ($12)



PokerStars Game #59892838190:  Hold'em No Limit ($3/$6 USD) - 2011/03/27 13:09:59 ET
Table 'Lexell XI' 2-max Seat #1 is the button
Seat 1: fightingnuns ($617.50 in chips) 
Seat 2: mascom ($956.50 in chips) 
fightingnuns: posts small blind $3
mascom: posts big blind $6
*** HOLE CARDS ***
Dealt to fightingnuns [Th Ks]
fightingnuns: raises $6 to $12
mascom: raises $23 to $35
fightingnuns: calls $23
*** FLOP *** [8s 5c 8h]
mascom: bets $60
fightingnuns: folds 
Uncalled bet ($60) returned to mascom
mascom collected $69.50 from pot
*** SUMMARY ***
Total pot $70 | Rake $0.50 
Board [8s 5c 8h]
Seat 1: fightingnuns (button) (small blind) folded on the Flop
Seat 2: mascom (big blind) collected ($69.50)



PokerStars Game #59892862170:  Hold'em No Limit ($3/$6 USD) - 2011/03/27 13:10:23 ET
Table 'Lexell XI' 2-max Seat #2 is the button
Seat 1: fightingnuns ($600 in chips) 
Seat 2: mascom ($991 in chips) 
mascom: posts small blind $3
fightingnuns: posts big blind $6
*** HOLE CARDS ***
Dealt to fightingnuns [2s 3s]
mascom: raises $6 to $12
fightingnuns: folds 
Uncalled bet ($6) returned to mascom
mascom collected $12 from pot
*** SUMMARY ***
Total pot $12 | Rake $0 
Seat 1: fightingnuns (big blind) folded before Flop
Seat 2: mascom (button) (small blind) collected ($12)



PokerStars Game #59890753426:  Hold'em No Limit ($2/$4 USD) - 2011/03/27 12:32:33 ET
Table 'Castor IX' 2-max Seat #2 is the button
Seat 1: fightingnuns ($200 in chips) 
Seat 2: ainzooo ($200 in chips) 
ainzooo: posts small blind $2
fightingnuns: posts big blind $4
*** HOLE CARDS ***
Dealt to fightingnuns [5c Qs]
ainzooo: raises $4 to $8
fightingnuns: folds 
Uncalled bet ($4) returned to ainzooo
ainzooo collected $8 from pot
*** SUMMARY ***
Total pot $8 | Rake $0 
Seat 1: fightingnuns (big blind) folded before Flop
Seat 2: ainzooo (button) (small blind) collected ($8)



PokerStars Game #59890767339:  Hold'em No Limit ($2/$4 USD) - 2011/03/27 12:32:48 ET
Table 'Castor IX' 2-max Seat #1 is the button
Seat 1: fightingnuns ($200 in chips) 
Seat 2: ainzooo ($204 in chips) 
fightingnuns: posts small blind $2
ainzooo: posts big blind $4
*** HOLE CARDS ***
Dealt to fightingnuns [5d 3d]
fightingnuns: raises $4 to $8
ainzooo: raises $16 to $24
fightingnuns: folds 
Uncalled bet ($16) returned to ainzooo
ainzooo collected $16 from pot
*** SUMMARY ***
Total pot $16 | Rake $0 
Seat 1: fightingnuns (button) (small blind) folded before Flop
Seat 2: ainzooo (big blind) collected ($16)



PokerStars Game #59890777592:  Hold'em No Limit ($2/$4 USD) - 2011/03/27 12:32:59 ET
Table 'Castor IX' 2-max Seat #2 is the button
Seat 1: fightingnuns ($200 in chips) 
Seat 2: ainzooo ($212 in chips) 
ainzooo: posts small blind $2
fightingnuns: posts big blind $4
*** HOLE CARDS ***
Dealt to fightingnuns [9h Ac]
ainzooo: raises $4 to $8
fightingnuns: calls $4
*** FLOP *** [7d 3h 2d]
fightingnuns: checks 
ainzooo: bets $16
fightingnuns: folds 
Uncalled bet ($16) returned to ainzooo
ainzooo collected $15.50 from pot
ainzooo: doesn't show hand 
*** SUMMARY ***
Total pot $16 | Rake $0.50 
Board [7d 3h 2d]
Seat 1: fightingnuns (big blind) folded on the Flop
Seat 2: ainzooo (button) (small blind) collected ($15.50)



PokerStars Game #59890792732:  Hold'em No Limit ($2/$4 USD) - 2011/03/27 12:33:15 ET
Table 'Castor IX' 2-max Seat #1 is the button
Seat 1: fightingnuns ($200 in chips) 
Seat 2: ainzooo ($219.50 in chips) 
fightingnuns: posts small blind $2
ainzooo: posts big blind $4
*** HOLE CARDS ***
Dealt to fightingnuns [5d 4c]
fightingnuns: folds 
Uncalled bet ($2) returned to ainzooo
ainzooo collected $4 from pot
*** SUMMARY ***
Total pot $4 | Rake $0 
Seat 1: fightingnuns (button) (small blind) folded before Flop
Seat 2: ainzooo (big blind) collected ($4)



PokerStars Game #59890797607:  Hold'em No Limit ($2/$4 USD) - 2011/03/27 12:33:21 ET
Table 'Castor IX' 2-max Seat #2 is the button
Seat 1: fightingnuns ($200 in chips) 
Seat 2: ainzooo ($221.50 in chips) 
ainzooo: posts small blind $2
fightingnuns: posts big blind $4
*** HOLE CARDS ***
Dealt to fightingnuns [6c 5s]
ainzooo: raises $4 to $8
fightingnuns: folds 
Uncalled bet ($4) returned to ainzooo
ainzooo collected $8 from pot
*** SUMMARY ***
Total pot $8 | Rake $0 
Seat 1: fightingnuns (big blind) folded before Flop
Seat 2: ainzooo (button) (small blind) collected ($8)



PokerStars Game #59890811027:  Hold'em No Limit ($2/$4 USD) - 2011/03/27 12:33:35 ET
Table 'Castor IX' 2-max Seat #1 is the button
Seat 1: fightingnuns ($200 in chips) 
Seat 2: ainzooo ($225.50 in chips) 
fightingnuns: posts small blind $2
ainzooo: posts big blind $4
*** HOLE CARDS ***
Dealt to fightingnuns [5c 4s]
fightingnuns: folds 
Uncalled bet ($2) returned to ainzooo
ainzooo collected $4 from pot
*** SUMMARY ***
Total pot $4 | Rake $0 
Seat 1: fightingnuns (button) (small blind) folded before Flop
Seat 2: ainzooo (big blind) collected ($4)



PokerStars Game #59890817927:  Hold'em No Limit ($2/$4 USD) - 2011/03/27 12:33:43 ET
Table 'Castor IX' 2-max Seat #2 is the button
Seat 1: fightingnuns ($200 in chips) 
Seat 2: ainzooo ($227.50 in chips) 
ainzooo: posts small blind $2
fightingnuns: posts big blind $4
*** HOLE CARDS ***
Dealt to fightingnuns [2h 4d]
ainzooo: raises $4 to $8
fightingnuns: folds 
Uncalled bet ($4) returned to ainzooo
ainzooo collected $8 from pot
*** SUMMARY ***
Total pot $8 | Rake $0 
Seat 1: fightingnuns (big blind) folded before Flop
Seat 2: ainzooo (button) (small blind) collected ($8)



PokerStars Game #59890824958:  Hold'em No Limit ($2/$4 USD) - 2011/03/27 12:33:50 ET
Table 'Castor IX' 2-max Seat #1 is the button
Seat 1: fightingnuns ($200 in chips) 
Seat 2: ainzooo ($231.50 in chips) 
fightingnuns: posts small blind $2
ainzooo: posts big blind $4
*** HOLE CARDS ***
Dealt to fightingnuns [Th 2s]
fightingnuns: folds 
Uncalled bet ($2) returned to ainzooo
ainzooo collected $4 from pot
*** SUMMARY ***
Total pot $4 | Rake $0 
Seat 1: fightingnuns (button) (small blind) folded before Flop
Seat 2: ainzooo (big blind) collected ($4)



PokerStars Game #59890831759:  Hold'em No Limit ($2/$4 USD) - 2011/03/27 12:33:57 ET
Table 'Castor IX' 2-max Seat #2 is the button
Seat 1: fightingnuns ($200 in chips) 
Seat 2: ainzooo ($233.50 in chips) 
ainzooo: posts small blind $2
fightingnuns: posts big blind $4
*** HOLE CARDS ***
Dealt to fightingnuns [4s Jh]
ainzooo: raises $4 to $8
fightingnuns: folds 
Uncalled bet ($4) returned to ainzooo
ainzooo collected $8 from pot
*** SUMMARY ***
Total pot $8 | Rake $0 
Seat 1: fightingnuns (big blind) folded before Flop
Seat 2: ainzooo (button) (small blind) collected ($8)



PokerStars Game #59890839696:  Hold'em No Limit ($2/$4 USD) - 2011/03/27 12:34:06 ET
Table 'Castor IX' 2-max Seat #1 is the button
Seat 1: fightingnuns ($200 in chips) 
Seat 2: ainzooo ($237.50 in chips) 
fightingnuns: posts small blind $2
ainzooo: posts big blind $4
*** HOLE CARDS ***
Dealt to fightingnuns [8c Ts]
fightingnuns: raises $4 to $8
ainzooo: calls $4
*** FLOP *** [3s Ac Tc]
ainzooo: checks 
fightingnuns: checks 
*** TURN *** [3s Ac Tc] [Qd]
ainzooo: bets $8
fightingnuns: calls $8
*** RIVER *** [3s Ac Tc Qd] [Kd]
ainzooo: checks 
fightingnuns: bets $24
ainzooo: calls $24
*** SHOW DOWN ***
fightingnuns: shows [8c Ts] (a pair of Tens)
ainzooo: shows [As 4d] (a pair of Aces)
ainzooo collected $79.50 from pot
*** SUMMARY ***
Total pot $80 | Rake $0.50 
Board [3s Ac Tc Qd Kd]
Seat 1: fightingnuns (button) (small blind) showed [8c Ts] and lost with a pair of Tens
Seat 2: ainzooo (big blind) showed [As 4d] and won ($79.50) with a pair of Aces



PokerStars Game #59890875656:  Hold'em No Limit ($2/$4 USD) - 2011/03/27 12:34:44 ET
Table 'Castor IX' 2-max Seat #2 is the button
Seat 1: fightingnuns ($200 in chips) 
Seat 2: ainzooo ($277 in chips) 
ainzooo: posts small blind $2
fightingnuns: posts big blind $4
*** HOLE CARDS ***
Dealt to fightingnuns [6c 7c]
ainzooo: raises $4 to $8
fightingnuns: folds 
Uncalled bet ($4) returned to ainzooo
ainzooo collected $8 from pot
*** SUMMARY ***
Total pot $8 | Rake $0 
Seat 1: fightingnuns (big blind) folded before Flop
Seat 2: ainzooo (button) (small blind) collected ($8)



PokerStars Game #59890883189:  Hold'em No Limit ($2/$4 USD) - 2011/03/27 12:34:52 ET
Table 'Castor IX' 2-max Seat #1 is the button
Seat 1: fightingnuns ($200 in chips) 
Seat 2: ainzooo ($281 in chips) 
fightingnuns: posts small blind $2
ainzooo: posts big blind $4
*** HOLE CARDS ***
Dealt to fightingnuns [Ad 3d]
fightingnuns: raises $8 to $12
ainzooo: folds 
Uncalled bet ($8) returned to fightingnuns
fightingnuns collected $8 from pot
fightingnuns: doesn't show hand 
*** SUMMARY ***
Total pot $8 | Rake $0 
Seat 1: fightingnuns (button) (small blind) collected ($8)
Seat 2: ainzooo (big blind) folded before Flop



PokerStars Game #59890891059:  Hold'em No Limit ($2/$4 USD) - 2011/03/27 12:35:01 ET
Table 'Castor IX' 2-max Seat #2 is the button
Seat 1: fightingnuns ($204 in chips) 
Seat 2: ainzooo ($277 in chips) 
ainzooo: posts small blind $2
fightingnuns: posts big blind $4
*** HOLE CARDS ***
Dealt to fightingnuns [Jd 8c]
ainzooo: raises $8 to $12
fightingnuns: folds 
Uncalled bet ($8) returned to ainzooo
ainzooo collected $8 from pot
*** SUMMARY ***
Total pot $8 | Rake $0 
Seat 1: fightingnuns (big blind) folded before Flop
Seat 2: ainzooo (button) (small blind) collected ($8)



PokerStars Game #59890901681:  Hold'em No Limit ($2/$4 USD) - 2011/03/27 12:35:12 ET
Table 'Castor IX' 2-max Seat #1 is the button
Seat 1: fightingnuns ($200 in chips) 
Seat 2: ainzooo ($281 in chips) 
fightingnuns: posts small blind $2
ainzooo: posts big blind $4
*** HOLE CARDS ***
Dealt to fightingnuns [8c 4d]
fightingnuns: folds 
Uncalled bet ($2) returned to ainzooo
ainzooo collected $4 from pot
*** SUMMARY ***
Total pot $4 | Rake $0 
Seat 1: fightingnuns (button) (small blind) folded before Flop
Seat 2: ainzooo (big blind) collected ($4)



PokerStars Game #59890907198:  Hold'em No Limit ($2/$4 USD) - 2011/03/27 12:35:18 ET
Table 'Castor IX' 2-max Seat #2 is the button
Seat 1: fightingnuns ($200 in chips) 
Seat 2: ainzooo ($283 in chips) 
ainzooo: posts small blind $2
fightingnuns: posts big blind $4
*** HOLE CARDS ***
Dealt to fightingnuns [Jh As]
ainzooo: raises $4 to $8
fightingnuns: raises $16 to $24
ainzooo: calls $16
*** FLOP *** [Kh Kd Td]
fightingnuns: checks 
ainzooo: checks 
*** TURN *** [Kh Kd Td] [Th]
fightingnuns: checks 
ainzooo: checks 
*** RIVER *** [Kh Kd Td Th] [5d]
fightingnuns: checks 
ainzooo: checks 
*** SHOW DOWN ***
fightingnuns: shows [Jh As] (two pair, Kings and Tens)
ainzooo: mucks hand 
fightingnuns collected $47.50 from pot
*** SUMMARY ***
Total pot $48 | Rake $0.50 
Board [Kh Kd Td Th 5d]
Seat 1: fightingnuns (big blind) showed [Jh As] and won ($47.50) with two pair, Kings and Tens
Seat 2: ainzooo (button) (small blind) mucked [Qs Jc]



PokerStars Game #59890939878:  Hold'em No Limit ($2/$4 USD) - 2011/03/27 12:35:53 ET
Table 'Castor IX' 2-max Seat #1 is the button
Seat 1: fightingnuns ($223.50 in chips) 
Seat 2: ainzooo ($259 in chips) 
fightingnuns: posts small blind $2
ainzooo: posts big blind $4
*** HOLE CARDS ***
Dealt to fightingnuns [Kh 7h]
fightingnuns: raises $4 to $8
ainzooo: calls $4
*** FLOP *** [6s Td 7c]
ainzooo: checks 
fightingnuns: checks 
*** TURN *** [6s Td 7c] [Ad]
ainzooo: bets $8
fightingnuns: folds 
Uncalled bet ($8) returned to ainzooo
ainzooo collected $15.50 from pot
*** SUMMARY ***
Total pot $16 | Rake $0.50 
Board [6s Td 7c Ad]
Seat 1: fightingnuns (button) (small blind) folded on the Turn
Seat 2: ainzooo (big blind) collected ($15.50)



PokerStars Game #59890957549:  Hold'em No Limit ($2/$4 USD) - 2011/03/27 12:36:12 ET
Table 'Castor IX' 2-max Seat #2 is the button
Seat 1: fightingnuns ($215.50 in chips) 
Seat 2: ainzooo ($266.50 in chips) 
ainzooo: posts small blind $2
fightingnuns: posts big blind $4
*** HOLE CARDS ***
Dealt to fightingnuns [Jd 5d]
ainzooo: folds 
Uncalled bet ($2) returned to fightingnuns
fightingnuns collected $4 from pot
fightingnuns: doesn't show hand 
*** SUMMARY ***
Total pot $4 | Rake $0 
Seat 1: fightingnuns (big blind) collected ($4)
Seat 2: ainzooo (button) (small blind) folded before Flop



PokerStars Game #59890962793:  Hold'em No Limit ($2/$4 USD) - 2011/03/27 12:36:17 ET
Table 'Castor IX' 2-max Seat #1 is the button
Seat 1: fightingnuns ($217.50 in chips) 
Seat 2: ainzooo ($264.50 in chips) 
fightingnuns: posts small blind $2
ainzooo: posts big blind $4
*** HOLE CARDS ***
Dealt to fightingnuns [Jd 5s]
fightingnuns: folds 
Uncalled bet ($2) returned to ainzooo
ainzooo collected $4 from pot
ainzooo: doesn't show hand 
*** SUMMARY ***
Total pot $4 | Rake $0 
Seat 1: fightingnuns (button) (small blind) folded before Flop
Seat 2: ainzooo (big blind) collected ($4)



PokerStars Game #59890968872:  Hold'em No Limit ($2/$4 USD) - 2011/03/27 12:36:24 ET
Table 'Castor IX' 2-max Seat #2 is the button
Seat 1: fightingnuns ($215.50 in chips) 
Seat 2: ainzooo ($266.50 in chips) 
ainzooo: posts small blind $2
fightingnuns: posts big blind $4
*** HOLE CARDS ***
Dealt to fightingnuns [2h 5d]
ainzooo: raises $4 to $8
fightingnuns: folds 
Uncalled bet ($4) returned to ainzooo
ainzooo collected $8 from pot
*** SUMMARY ***
Total pot $8 | Rake $0 
Seat 1: fightingnuns (big blind) folded before Flop
Seat 2: ainzooo (button) (small blind) collected ($8)



PokerStars Game #59890978258:  Hold'em No Limit ($2/$4 USD) - 2011/03/27 12:36:34 ET
Table 'Castor IX' 2-max Seat #1 is the button
Seat 1: fightingnuns ($211.50 in chips) 
Seat 2: ainzooo ($270.50 in chips) 
fightingnuns: posts small blind $2
ainzooo: posts big blind $4
*** HOLE CARDS ***
Dealt to fightingnuns [3s 2d]
fightingnuns: folds 
Uncalled bet ($2) returned to ainzooo
ainzooo collected $4 from pot
*** SUMMARY ***
Total pot $4 | Rake $0 
Seat 1: fightingnuns (button) (small blind) folded before Flop
Seat 2: ainzooo (big blind) collected ($4)



PokerStars Game #59890984158:  Hold'em No Limit ($2/$4 USD) - 2011/03/27 12:36:40 ET
Table 'Castor IX' 2-max Seat #2 is the button
Seat 1: fightingnuns ($209.50 in chips) 
Seat 2: ainzooo ($272.50 in chips) 
ainzooo: posts small blind $2
fightingnuns: posts big blind $4
*** HOLE CARDS ***
Dealt to fightingnuns [7c 6s]
ainzooo: folds 
Uncalled bet ($2) returned to fightingnuns
fightingnuns collected $4 from pot
fightingnuns: doesn't show hand 
*** SUMMARY ***
Total pot $4 | Rake $0 
Seat 1: fightingnuns (big blind) collected ($4)
Seat 2: ainzooo (button) (small blind) folded before Flop



PokerStars Game #59890989367:  Hold'em No Limit ($2/$4 USD) - 2011/03/27 12:36:46 ET
Table 'Castor IX' 2-max Seat #1 is the button
Seat 1: fightingnuns ($211.50 in chips) 
Seat 2: ainzooo ($270.50 in chips) 
fightingnuns: posts small blind $2
ainzooo: posts big blind $4
*** HOLE CARDS ***
Dealt to fightingnuns [6s 8h]
fightingnuns: raises $4 to $8
ainzooo: raises $8 to $16
fightingnuns: calls $8
*** FLOP *** [Ac 7s 8d]
ainzooo: bets $16
fightingnuns: calls $16
*** TURN *** [Ac 7s 8d] [Ah]
ainzooo: bets $20
fightingnuns: calls $20
*** RIVER *** [Ac 7s 8d Ah] [Jd]
ainzooo: checks 
fightingnuns: checks 
*** SHOW DOWN ***
ainzooo: shows [Ts Tc] (two pair, Aces and Tens)
fightingnuns: mucks hand 
ainzooo collected $103.50 from pot
*** SUMMARY ***
Total pot $104 | Rake $0.50 
Board [Ac 7s 8d Ah Jd]
Seat 1: fightingnuns (button) (small blind) mucked [6s 8h]
Seat 2: ainzooo (big blind) showed [Ts Tc] and won ($103.50) with two pair, Aces and Tens



PokerStars Game #59891026065:  Hold'em No Limit ($2/$4 USD) - 2011/03/27 12:37:25 ET
Table 'Castor IX' 2-max Seat #2 is the button
Seat 1: fightingnuns ($200 in chips) 
Seat 2: ainzooo ($322 in chips) 
ainzooo: posts small blind $2
fightingnuns: posts big blind $4
*** HOLE CARDS ***
Dealt to fightingnuns [Qh 8c]
ainzooo: raises $4 to $8
fightingnuns: folds 
Uncalled bet ($4) returned to ainzooo
ainzooo collected $8 from pot
*** SUMMARY ***
Total pot $8 | Rake $0 
Seat 1: fightingnuns (big blind) folded before Flop
Seat 2: ainzooo (button) (small blind) collected ($8)



PokerStars Game #59891032818:  Hold'em No Limit ($2/$4 USD) - 2011/03/27 12:37:32 ET
Table 'Castor IX' 2-max Seat #1 is the button
Seat 1: fightingnuns ($200 in chips) 
Seat 2: ainzooo ($326 in chips) 
fightingnuns: posts small blind $2
ainzooo: posts big blind $4
*** HOLE CARDS ***
Dealt to fightingnuns [Ts 2s]
fightingnuns: raises $4 to $8
ainzooo: folds 
Uncalled bet ($4) returned to fightingnuns
fightingnuns collected $8 from pot
fightingnuns: doesn't show hand 
*** SUMMARY ***
Total pot $8 | Rake $0 
Seat 1: fightingnuns (button) (small blind) collected ($8)
Seat 2: ainzooo (big blind) folded before Flop



PokerStars Game #59891039965:  Hold'em No Limit ($2/$4 USD) - 2011/03/27 12:37:40 ET
Table 'Castor IX' 2-max Seat #2 is the button
Seat 1: fightingnuns ($204 in chips) 
Seat 2: ainzooo ($322 in chips) 
ainzooo: posts small blind $2
fightingnuns: posts big blind $4
*** HOLE CARDS ***
Dealt to fightingnuns [Ah 2s]
ainzooo: folds 
Uncalled bet ($2) returned to fightingnuns
fightingnuns collected $4 from pot
fightingnuns: doesn't show hand 
*** SUMMARY ***
Total pot $4 | Rake $0 
Seat 1: fightingnuns (big blind) collected ($4)
Seat 2: ainzooo (button) (small blind) folded before Flop



PokerStars Game #59891045405:  Hold'em No Limit ($2/$4 USD) - 2011/03/27 12:37:45 ET
Table 'Castor IX' 2-max Seat #1 is the button
Seat 1: fightingnuns ($206 in chips) 
Seat 2: ainzooo ($320 in chips) 
fightingnuns: posts small blind $2
ainzooo: posts big blind $4
*** HOLE CARDS ***
Dealt to fightingnuns [Kc Kd]
fightingnuns: raises $4 to $8
ainzooo: calls $4
*** FLOP *** [Ts 2c 8h]
ainzooo: checks 
fightingnuns: bets $12
ainzooo: folds 
Uncalled bet ($12) returned to fightingnuns
fightingnuns collected $15.50 from pot
fightingnuns: doesn't show hand 
*** SUMMARY ***
Total pot $16 | Rake $0.50 
Board [Ts 2c 8h]
Seat 1: fightingnuns (button) (small blind) collected ($15.50)
Seat 2: ainzooo (big blind) folded on the Flop



PokerStars Game #59891059161:  Hold'em No Limit ($2/$4 USD) - 2011/03/27 12:38:00 ET
Table 'Castor IX' 2-max Seat #2 is the button
Seat 1: fightingnuns ($213.50 in chips) 
Seat 2: ainzooo ($312 in chips) 
ainzooo: posts small blind $2
fightingnuns: posts big blind $4
*** HOLE CARDS ***
Dealt to fightingnuns [6h 8c]
ainzooo: raises $4 to $8
fightingnuns: folds 
Uncalled bet ($4) returned to ainzooo
ainzooo collected $8 from pot
*** SUMMARY ***
Total pot $8 | Rake $0 
Seat 1: fightingnuns (big blind) folded before Flop
Seat 2: ainzooo (button) (small blind) collected ($8)



PokerStars Game #59891065700:  Hold'em No Limit ($2/$4 USD) - 2011/03/27 12:38:07 ET
Table 'Castor IX' 2-max Seat #1 is the button
Seat 1: fightingnuns ($209.50 in chips) 
Seat 2: ainzooo ($316 in chips) 
fightingnuns: posts small blind $2
ainzooo: posts big blind $4
*** HOLE CARDS ***
Dealt to fightingnuns [6h Ad]
fightingnuns: raises $4 to $8
ainzooo: calls $4
*** FLOP *** [Qh 2h Qc]
ainzooo: checks 
fightingnuns: checks 
*** TURN *** [Qh 2h Qc] [6c]
ainzooo: bets $8
fightingnuns: raises $16 to $24
ainzooo: folds 
Uncalled bet ($16) returned to fightingnuns
fightingnuns collected $31.50 from pot
fightingnuns: doesn't show hand 
*** SUMMARY ***
Total pot $32 | Rake $0.50 
Board [Qh 2h Qc 6c]
Seat 1: fightingnuns (button) (small blind) collected ($31.50)
Seat 2: ainzooo (big blind) folded on the Turn



PokerStars Game #59891092388:  Hold'em No Limit ($2/$4 USD) - 2011/03/27 12:38:36 ET
Table 'Castor IX' 2-max Seat #2 is the button
Seat 1: fightingnuns ($225 in chips) 
Seat 2: ainzooo ($300 in chips) 
ainzooo: posts small blind $2
fightingnuns: posts big blind $4
*** HOLE CARDS ***
Dealt to fightingnuns [Jd 8c]
ainzooo: raises $4 to $8
fightingnuns: folds 
Uncalled bet ($4) returned to ainzooo
ainzooo collected $8 from pot
*** SUMMARY ***
Total pot $8 | Rake $0 
Seat 1: fightingnuns (big blind) folded before Flop
Seat 2: ainzooo (button) (small blind) collected ($8)



PokerStars Game #59891100497:  Hold'em No Limit ($2/$4 USD) - 2011/03/27 12:38:45 ET
Table 'Castor IX' 2-max Seat #1 is the button
Seat 1: fightingnuns ($221 in chips) 
Seat 2: ainzooo ($304 in chips) 
fightingnuns: posts small blind $2
ainzooo: posts big blind $4
*** HOLE CARDS ***
Dealt to fightingnuns [6c 3s]
fightingnuns: folds 
Uncalled bet ($2) returned to ainzooo
ainzooo collected $4 from pot
ainzooo: doesn't show hand 
*** SUMMARY ***
Total pot $4 | Rake $0 
Seat 1: fightingnuns (button) (small blind) folded before Flop
Seat 2: ainzooo (big blind) collected ($4)



PokerStars Game #59891107103:  Hold'em No Limit ($2/$4 USD) - 2011/03/27 12:38:52 ET
Table 'Castor IX' 2-max Seat #2 is the button
Seat 1: fightingnuns ($219 in chips) 
Seat 2: ainzooo ($306 in chips) 
ainzooo: posts small blind $2
fightingnuns: posts big blind $4
*** HOLE CARDS ***
Dealt to fightingnuns [2d 4s]
ainzooo: raises $4 to $8
fightingnuns: folds 
Uncalled bet ($4) returned to ainzooo
ainzooo collected $8 from pot
ainzooo: doesn't show hand 
*** SUMMARY ***
Total pot $8 | Rake $0 
Seat 1: fightingnuns (big blind) folded before Flop
Seat 2: ainzooo (button) (small blind) collected ($8)



PokerStars Game #59891114251:  Hold'em No Limit ($2/$4 USD) - 2011/03/27 12:38:59 ET
Table 'Castor IX' 2-max Seat #1 is the button
Seat 1: fightingnuns ($215 in chips) 
Seat 2: ainzooo ($310 in chips) 
fightingnuns: posts small blind $2
ainzooo: posts big blind $4
*** HOLE CARDS ***
Dealt to fightingnuns [8s 5s]
fightingnuns: raises $4 to $8
ainzooo: calls $4
*** FLOP *** [Kh 3h 8d]
ainzooo: checks 
fightingnuns: bets $12
ainzooo: folds 
Uncalled bet ($12) returned to fightingnuns
fightingnuns collected $15.50 from pot
fightingnuns: doesn't show hand 
*** SUMMARY ***
Total pot $16 | Rake $0.50 
Board [Kh 3h 8d]
Seat 1: fightingnuns (button) (small blind) collected ($15.50)
Seat 2: ainzooo (big blind) folded on the Flop



PokerStars Game #59891148013:  Hold'em No Limit ($2/$4 USD) - 2011/03/27 12:39:36 ET
Table 'Castor IX' 2-max Seat #2 is the button
Seat 1: fightingnuns ($222.50 in chips) 
Seat 2: ainzooo ($302 in chips) 
ainzooo: posts small blind $2
fightingnuns: posts big blind $4
*** HOLE CARDS ***
Dealt to fightingnuns [Ad 3s]
ainzooo: folds 
Uncalled bet ($2) returned to fightingnuns
fightingnuns collected $4 from pot
fightingnuns: doesn't show hand 
*** SUMMARY ***
Total pot $4 | Rake $0 
Seat 1: fightingnuns (big blind) collected ($4)
Seat 2: ainzooo (button) (small blind) folded before Flop



PokerStars Game #59891153402:  Hold'em No Limit ($2/$4 USD) - 2011/03/27 12:39:42 ET
Table 'Castor IX' 2-max Seat #1 is the button
Seat 1: fightingnuns ($224.50 in chips) 
Seat 2: ainzooo ($300 in chips) 
fightingnuns: posts small blind $2
ainzooo: posts big blind $4
*** HOLE CARDS ***
Dealt to fightingnuns [Th 7d]
fightingnuns: raises $4 to $8
ainzooo: folds 
Uncalled bet ($4) returned to fightingnuns
fightingnuns collected $8 from pot
fightingnuns: doesn't show hand 
*** SUMMARY ***
Total pot $8 | Rake $0 
Seat 1: fightingnuns (button) (small blind) collected ($8)
Seat 2: ainzooo (big blind) folded before Flop



PokerStars Game #59892837992:  Hold'em No Limit ($2/$4 USD) - 2011/03/27 13:09:59 ET
Table 'Castor IX' 2-max Seat #2 is the button
Seat 1: fightingnuns ($228.50 in chips) 
Seat 2: Bentlys ($200 in chips) 
Bentlys: posts small blind $2
fightingnuns: posts big blind $4
*** HOLE CARDS ***
Dealt to fightingnuns [5c 7s]
Bentlys: raises $12 to $16
fightingnuns: folds 
Uncalled bet ($12) returned to Bentlys
Bentlys collected $8 from pot
*** SUMMARY ***
Total pot $8 | Rake $0 
Seat 1: fightingnuns (big blind) folded before Flop
Seat 2: Bentlys (button) (small blind) collected ($8)



PokerStars Game #59892860871:  Hold'em No Limit ($2/$4 USD) - 2011/03/27 13:10:22 ET
Table 'Castor IX' 2-max Seat #1 is the button
Seat 1: fightingnuns ($224.50 in chips) 
Seat 2: Bentlys ($204 in chips) 
fightingnuns: posts small blind $2
Bentlys: posts big blind $4
*** HOLE CARDS ***
Dealt to fightingnuns [7s 5h]
fightingnuns: raises $4 to $8
Bentlys: folds 
Uncalled bet ($4) returned to fightingnuns
fightingnuns collected $8 from pot
fightingnuns: doesn't show hand 
*** SUMMARY ***
Total pot $8 | Rake $0 
Seat 1: fightingnuns (button) (small blind) collected ($8)
Seat 2: Bentlys (big blind) folded before Flop



PokerStars Game #59892873042:  Hold'em No Limit ($2/$4 USD) - 2011/03/27 13:10:34 ET
Table 'Castor IX' 2-max Seat #2 is the button
Seat 1: fightingnuns ($228.50 in chips) 
Seat 2: Bentlys ($200 in chips) 
Bentlys: posts small blind $2
fightingnuns: posts big blind $4
*** HOLE CARDS ***
Dealt to fightingnuns [As Ts]
Bentlys: calls $2
fightingnuns: raises $12 to $16
Bentlys: calls $12
*** FLOP *** [Ad 6s 2s]
fightingnuns: bets $20
Bentlys: calls $20
*** TURN *** [Ad 6s 2s] [4s]
fightingnuns: bets $40
Bentlys: folds 
Uncalled bet ($40) returned to fightingnuns
fightingnuns collected $71.50 from pot
fightingnuns: doesn't show hand 
*** SUMMARY ***
Total pot $72 | Rake $0.50 
Board [Ad 6s 2s 4s]
Seat 1: fightingnuns (big blind) collected ($71.50)
Seat 2: Bentlys (button) (small blind) folded on the Turn



PokerStars Game #59892922089:  Hold'em No Limit ($2/$4 USD) - 2011/03/27 13:11:21 ET
Table 'Castor IX' 2-max Seat #1 is the button
Seat 1: fightingnuns ($264 in chips) 
Seat 2: Bentlys ($164 in chips) 
fightingnuns: posts small blind $2
Bentlys: posts big blind $4
*** HOLE CARDS ***
Dealt to fightingnuns [2h 9d]
fightingnuns: folds 
Uncalled bet ($2) returned to Bentlys
Bentlys collected $4 from pot
*** SUMMARY ***
Total pot $4 | Rake $0 
Seat 1: fightingnuns (button) (small blind) folded before Flop
Seat 2: Bentlys (big blind) collected ($4)



PokerStars Game #59892928909:  Hold'em No Limit ($2/$4 USD) - 2011/03/27 13:11:28 ET
Table 'Castor IX' 2-max Seat #2 is the button
Seat 1: fightingnuns ($262 in chips) 
Seat 2: Bentlys ($166 in chips) 
Bentlys: posts small blind $2
fightingnuns: posts big blind $4
*** HOLE CARDS ***
Dealt to fightingnuns [5s 4h]
Bentlys: raises $4 to $8
fightingnuns: folds 
Uncalled bet ($4) returned to Bentlys
Bentlys collected $8 from pot
*** SUMMARY ***
Total pot $8 | Rake $0 
Seat 1: fightingnuns (big blind) folded before Flop
Seat 2: Bentlys (button) (small blind) collected ($8)



PokerStars Game #59892942625:  Hold'em No Limit ($2/$4 USD) - 2011/03/27 13:11:41 ET
Table 'Castor IX' 2-max Seat #1 is the button
Seat 1: fightingnuns ($258 in chips) 
Seat 2: Bentlys ($170 in chips) 
fightingnuns: posts small blind $2
Bentlys: posts big blind $4
*** HOLE CARDS ***
Dealt to fightingnuns [6h 3s]
fightingnuns: folds 
Uncalled bet ($2) returned to Bentlys
Bentlys collected $4 from pot
*** SUMMARY ***
Total pot $4 | Rake $0 
Seat 1: fightingnuns (button) (small blind) folded before Flop
Seat 2: Bentlys (big blind) collected ($4)



PokerStars Game #59892951249:  Hold'em No Limit ($2/$4 USD) - 2011/03/27 13:11:50 ET
Table 'Castor IX' 2-max Seat #2 is the button
Seat 1: fightingnuns ($256 in chips) 
Seat 2: Bentlys ($172 in chips) 
Bentlys: posts small blind $2
fightingnuns: posts big blind $4
*** HOLE CARDS ***
Dealt to fightingnuns [Ad Ts]
Bentlys is disconnected 
Bentlys has timed out while disconnected
Bentlys: folds 
Uncalled bet ($2) returned to fightingnuns
fightingnuns collected $4 from pot
fightingnuns: doesn't show hand 
*** SUMMARY ***
Total pot $4 | Rake $0 
Seat 1: fightingnuns (big blind) collected ($4)
Seat 2: Bentlys (button) (small blind) folded before Flop



PokerStars Game #59893063283:  Hold'em No Limit ($2/$4 USD) - 2011/03/27 13:13:39 ET
Table 'Castor IX' 2-max Seat #1 is the button
Seat 1: fightingnuns ($258 in chips) 
Seat 2: Bentlys ($174.20 in chips) 
fightingnuns: posts small blind $2
Bentlys: posts big blind $4
*** HOLE CARDS ***
Dealt to fightingnuns [Kd Ac]
fightingnuns: raises $4 to $8
Bentlys: folds 
Uncalled bet ($4) returned to fightingnuns
fightingnuns collected $8 from pot
fightingnuns: doesn't show hand 
*** SUMMARY ***
Total pot $8 | Rake $0 
Seat 1: fightingnuns (button) (small blind) collected ($8)
Seat 2: Bentlys (big blind) folded before Flop



PokerStars Game #59893074734:  Hold'em No Limit ($2/$4 USD) - 2011/03/27 13:13:50 ET
Table 'Castor IX' 2-max Seat #2 is the button
Seat 1: fightingnuns ($262 in chips) 
Seat 2: Bentlys ($170.20 in chips) 
Bentlys: posts small blind $2
fightingnuns: posts big blind $4
*** HOLE CARDS ***
Dealt to fightingnuns [4h 9c]
Bentlys: raises $4 to $8
fightingnuns: folds 
Uncalled bet ($4) returned to Bentlys
Bentlys collected $8 from pot
*** SUMMARY ***
Total pot $8 | Rake $0 
Seat 1: fightingnuns (big blind) folded before Flop
Seat 2: Bentlys (button) (small blind) collected ($8)



PokerStars Game #59893085113:  Hold'em No Limit ($2/$4 USD) - 2011/03/27 13:14:00 ET
Table 'Castor IX' 2-max Seat #1 is the button
Seat 1: fightingnuns ($258 in chips) 
Seat 2: Bentlys ($174.20 in chips) 
fightingnuns: posts small blind $2
Bentlys: posts big blind $4
*** HOLE CARDS ***
Dealt to fightingnuns [Ah Kh]
fightingnuns: raises $4 to $8
Bentlys: calls $4
*** FLOP *** [Kc 2h 5c]
Bentlys: checks 
fightingnuns: bets $12
Bentlys: calls $12
*** TURN *** [Kc 2h 5c] [5s]
Bentlys: checks 
fightingnuns: bets $28
Bentlys: calls $28
*** RIVER *** [Kc 2h 5c 5s] [Tc]
Bentlys: checks 
fightingnuns: bets $60
Bentlys: calls $60
*** SHOW DOWN ***
fightingnuns: shows [Ah Kh] (two pair, Kings and Fives)
Bentlys: shows [3c Jc] (a flush, King high)
Bentlys collected $215.50 from pot
*** SUMMARY ***
Total pot $216 | Rake $0.50 
Board [Kc 2h 5c 5s Tc]
Seat 1: fightingnuns (button) (small blind) showed [Ah Kh] and lost with two pair, Kings and Fives
Seat 2: Bentlys (big blind) showed [3c Jc] and won ($215.50) with a flush, King high



PokerStars Game #59893134171:  Hold'em No Limit ($2/$4 USD) - 2011/03/27 13:14:48 ET
Table 'Castor IX' 2-max Seat #2 is the button
Seat 1: fightingnuns ($200 in chips) 
Seat 2: Bentlys ($281.70 in chips) 
Bentlys: posts small blind $2
fightingnuns: posts big blind $4
*** HOLE CARDS ***
Dealt to fightingnuns [Tc 6d]
Bentlys: raises $4 to $8
fightingnuns: folds 
Uncalled bet ($4) returned to Bentlys
Bentlys collected $8 from pot
*** SUMMARY ***
Total pot $8 | Rake $0 
Seat 1: fightingnuns (big blind) folded before Flop
Seat 2: Bentlys (button) (small blind) collected ($8)



PokerStars Game #59893145448:  Hold'em No Limit ($2/$4 USD) - 2011/03/27 13:14:59 ET
Table 'Castor IX' 2-max Seat #1 is the button
Seat 1: fightingnuns ($200 in chips) 
Seat 2: Bentlys ($285.70 in chips) 
fightingnuns: posts small blind $2
Bentlys: posts big blind $4
*** HOLE CARDS ***
Dealt to fightingnuns [Jd 5h]
fightingnuns: folds 
Uncalled bet ($2) returned to Bentlys
Bentlys collected $4 from pot
*** SUMMARY ***
Total pot $4 | Rake $0 
Seat 1: fightingnuns (button) (small blind) folded before Flop
Seat 2: Bentlys (big blind) collected ($4)



PokerStars Game #59893151990:  Hold'em No Limit ($2/$4 USD) - 2011/03/27 13:15:05 ET
Table 'Castor IX' 2-max Seat #2 is the button
Seat 1: fightingnuns ($200 in chips) 
Seat 2: Bentlys ($287.70 in chips) 
Bentlys: posts small blind $2
fightingnuns: posts big blind $4
*** HOLE CARDS ***
Dealt to fightingnuns [Qh Js]
Bentlys: raises $4 to $8
fightingnuns: raises $16 to $24
Bentlys: calls $16
*** FLOP *** [As 4s 5h]
fightingnuns: bets $32
Bentlys: calls $32
*** TURN *** [As 4s 5h] [4h]
fightingnuns: checks 
Bentlys: checks 
*** RIVER *** [As 4s 5h 4h] [2d]
fightingnuns: checks 
Bentlys: checks 
*** SHOW DOWN ***
fightingnuns: shows [Qh Js] (a pair of Fours)
Bentlys: shows [7s Ks] (a pair of Fours - Ace+King kicker)
Bentlys collected $111.50 from pot
*** SUMMARY ***
Total pot $112 | Rake $0.50 
Board [As 4s 5h 4h 2d]
Seat 1: fightingnuns (big blind) showed [Qh Js] and lost with a pair of Fours
Seat 2: Bentlys (button) (small blind) showed [7s Ks] and won ($111.50) with a pair of Fours



PokerStars Game #59893190603:  Hold'em No Limit ($2/$4 USD) - 2011/03/27 13:15:43 ET
Table 'Castor IX' 2-max Seat #1 is the button
Seat 1: fightingnuns ($200 in chips) 
Seat 2: Bentlys ($343.20 in chips) 
fightingnuns: posts small blind $2
Bentlys: posts big blind $4
*** HOLE CARDS ***
Dealt to fightingnuns [Jh 7s]
fightingnuns: raises $8 to $12
Bentlys: calls $8
*** FLOP *** [2h 4s Ks]
Bentlys: checks 
fightingnuns: bets $16
Bentlys: raises $16 to $32
fightingnuns: folds 
Uncalled bet ($16) returned to Bentlys
Bentlys collected $55.50 from pot
*** SUMMARY ***
Total pot $56 | Rake $0.50 
Board [2h 4s Ks]
Seat 1: fightingnuns (button) (small blind) folded on the Flop
Seat 2: Bentlys (big blind) collected ($55.50)



PokerStars Game #59893218238:  Hold'em No Limit ($2/$4 USD) - 2011/03/27 13:16:09 ET
Table 'Castor IX' 2-max Seat #2 is the button
Seat 1: fightingnuns ($200 in chips) 
Seat 2: Bentlys ($370.70 in chips) 
Bentlys: posts small blind $2
fightingnuns: posts big blind $4
*** HOLE CARDS ***
Dealt to fightingnuns [Kh 5c]
Bentlys: raises $8 to $12
fightingnuns: folds 
Uncalled bet ($8) returned to Bentlys
Bentlys collected $8 from pot
*** SUMMARY ***
Total pot $8 | Rake $0 
Seat 1: fightingnuns (big blind) folded before Flop
Seat 2: Bentlys (button) (small blind) collected ($8)



PokerStars Game #59893232731:  Hold'em No Limit ($2/$4 USD) - 2011/03/27 13:16:23 ET
Table 'Castor IX' 2-max Seat #1 is the button
Seat 1: fightingnuns ($200 in chips) 
Seat 2: Bentlys ($374.70 in chips) 
fightingnuns: posts small blind $2
Bentlys: posts big blind $4
*** HOLE CARDS ***
Dealt to fightingnuns [2s As]
fightingnuns: raises $8 to $12
Bentlys: calls $8
*** FLOP *** [Jd Ts Ad]
Bentlys: checks 
fightingnuns: bets $16
Bentlys: raises $16 to $32
fightingnuns: folds 
Uncalled bet ($16) returned to Bentlys
Bentlys collected $55.50 from pot
*** SUMMARY ***
Total pot $56 | Rake $0.50 
Board [Jd Ts Ad]
Seat 1: fightingnuns (button) (small blind) folded on the Flop
Seat 2: Bentlys (big blind) collected ($55.50)



PokerStars Game #59893258128:  Hold'em No Limit ($2/$4 USD) - 2011/03/27 13:16:47 ET
Table 'Castor IX' 2-max Seat #2 is the button
Seat 1: fightingnuns ($200 in chips) 
Seat 2: Bentlys ($402.20 in chips) 
Bentlys: posts small blind $2
fightingnuns: posts big blind $4
*** HOLE CARDS ***
Dealt to fightingnuns [9h 2d]
Bentlys: folds 
Uncalled bet ($2) returned to fightingnuns
fightingnuns collected $4 from pot
fightingnuns: doesn't show hand 
*** SUMMARY ***
Total pot $4 | Rake $0 
Seat 1: fightingnuns (big blind) collected ($4)
Seat 2: Bentlys (button) (small blind) folded before Flop



PokerStars Game #59893267358:  Hold'em No Limit ($2/$4 USD) - 2011/03/27 13:16:56 ET
Table 'Castor IX' 2-max Seat #1 is the button
Seat 1: fightingnuns ($202 in chips) 
Seat 2: Bentlys ($400.20 in chips) 
fightingnuns: posts small blind $2
Bentlys: posts big blind $4
*** HOLE CARDS ***
Dealt to fightingnuns [6s 8d]
fightingnuns: raises $8 to $12
Bentlys: calls $8
*** FLOP *** [5h Qc 9c]
Bentlys: checks 
fightingnuns: checks 
*** TURN *** [5h Qc 9c] [9d]
Bentlys: bets $16
fightingnuns: raises $32 to $48
Bentlys: calls $32
*** RIVER *** [5h Qc 9c 9d] [4s]
Bentlys: checks 
fightingnuns: checks 
*** SHOW DOWN ***
Bentlys: shows [Ac 3d] (a pair of Nines)
fightingnuns: mucks hand 
Bentlys collected $119.50 from pot
*** SUMMARY ***
Total pot $120 | Rake $0.50 
Board [5h Qc 9c 9d 4s]
Seat 1: fightingnuns (button) (small blind) mucked [6s 8d]
Seat 2: Bentlys (big blind) showed [Ac 3d] and won ($119.50) with a pair of Nines



PokerStars Game #59893306077:  Hold'em No Limit ($2/$4 USD) - 2011/03/27 13:17:33 ET
Table 'Castor IX' 2-max Seat #2 is the button
Seat 1: fightingnuns ($200 in chips) 
Seat 2: Bentlys ($459.70 in chips) 
Bentlys: posts small blind $2
fightingnuns: posts big blind $4
*** HOLE CARDS ***
Dealt to fightingnuns [2c 6d]
Bentlys: raises $12 to $16
fightingnuns: folds 
Uncalled bet ($12) returned to Bentlys
Bentlys collected $8 from pot
*** SUMMARY ***
Total pot $8 | Rake $0 
Seat 1: fightingnuns (big blind) folded before Flop
Seat 2: Bentlys (button) (small blind) collected ($8)



PokerStars Game #59893318645:  Hold'em No Limit ($2/$4 USD) - 2011/03/27 13:17:46 ET
Table 'Castor IX' 2-max Seat #1 is the button
Seat 1: fightingnuns ($200 in chips) 
Seat 2: Bentlys ($463.70 in chips) 
fightingnuns: posts small blind $2
Bentlys: posts big blind $4
*** HOLE CARDS ***
Dealt to fightingnuns [7h Tc]
fightingnuns: raises $4 to $8
Bentlys: folds 
Uncalled bet ($4) returned to fightingnuns
fightingnuns collected $8 from pot
fightingnuns: doesn't show hand 
*** SUMMARY ***
Total pot $8 | Rake $0 
Seat 1: fightingnuns (button) (small blind) collected ($8)
Seat 2: Bentlys (big blind) folded before Flop



PokerStars Game #59893331622:  Hold'em No Limit ($2/$4 USD) - 2011/03/27 13:17:58 ET
Table 'Castor IX' 2-max Seat #2 is the button
Seat 1: fightingnuns ($204 in chips) 
Seat 2: Bentlys ($459.70 in chips) 
Bentlys: posts small blind $2
fightingnuns: posts big blind $4
*** HOLE CARDS ***
Dealt to fightingnuns [Jd 8h]
Bentlys: folds 
Uncalled bet ($2) returned to fightingnuns
fightingnuns collected $4 from pot
fightingnuns: doesn't show hand 
*** SUMMARY ***
Total pot $4 | Rake $0 
Seat 1: fightingnuns (big blind) collected ($4)
Seat 2: Bentlys (button) (small blind) folded before Flop



PokerStars Game #59893340654:  Hold'em No Limit ($2/$4 USD) - 2011/03/27 13:18:07 ET
Table 'Castor IX' 2-max Seat #1 is the button
Seat 1: fightingnuns ($206 in chips) 
Seat 2: Bentlys ($457.70 in chips) 
fightingnuns: posts small blind $2
Bentlys: posts big blind $4
*** HOLE CARDS ***
Dealt to fightingnuns [7c Js]
fightingnuns: raises $4 to $8
Bentlys: raises $12 to $20
fightingnuns: calls $12
*** FLOP *** [2d 6h Ah]
Bentlys: checks 
fightingnuns: checks 
*** TURN *** [2d 6h Ah] [Tc]
Bentlys: bets $28
fightingnuns: folds 
Uncalled bet ($28) returned to Bentlys
Bentlys collected $39.50 from pot
*** SUMMARY ***
Total pot $40 | Rake $0.50 
Board [2d 6h Ah Tc]
Seat 1: fightingnuns (button) (small blind) folded on the Turn
Seat 2: Bentlys (big blind) collected ($39.50)



PokerStars Game #59893376926:  Hold'em No Limit ($2/$4 USD) - 2011/03/27 13:18:42 ET
Table 'Castor IX' 2-max Seat #2 is the button
Seat 1: fightingnuns ($200 in chips) 
Seat 2: Bentlys ($477.20 in chips) 
Bentlys: posts small blind $2
fightingnuns: posts big blind $4
*** HOLE CARDS ***
Dealt to fightingnuns [Jd 2d]
Bentlys: raises $8 to $12
fightingnuns: folds 
Uncalled bet ($8) returned to Bentlys
Bentlys collected $8 from pot
*** SUMMARY ***
Total pot $8 | Rake $0 
Seat 1: fightingnuns (big blind) folded before Flop
Seat 2: Bentlys (button) (small blind) collected ($8)



PokerStars Game #59893390969:  Hold'em No Limit ($2/$4 USD) - 2011/03/27 13:18:55 ET
Table 'Castor IX' 2-max Seat #1 is the button
Seat 1: fightingnuns ($200 in chips) 
Seat 2: Bentlys ($481.20 in chips) 
fightingnuns: posts small blind $2
Bentlys: posts big blind $4
*** HOLE CARDS ***
Dealt to fightingnuns [9s 5h]
fightingnuns: folds 
Uncalled bet ($2) returned to Bentlys
Bentlys collected $4 from pot
*** SUMMARY ***
Total pot $4 | Rake $0 
Seat 1: fightingnuns (button) (small blind) folded before Flop
Seat 2: Bentlys (big blind) collected ($4)



PokerStars Game #59893398058:  Hold'em No Limit ($2/$4 USD) - 2011/03/27 13:19:02 ET
Table 'Castor IX' 2-max Seat #2 is the button
Seat 1: fightingnuns ($200 in chips) 
Seat 2: Bentlys ($483.20 in chips) 
Bentlys: posts small blind $2
fightingnuns: posts big blind $4
*** HOLE CARDS ***
Dealt to fightingnuns [Qh Td]
Bentlys: raises $8 to $12
fightingnuns: calls $8
*** FLOP *** [2d Th Kd]
fightingnuns: checks 
Bentlys: bets $16
fightingnuns: calls $16
*** TURN *** [2d Th Kd] [2c]
fightingnuns: checks 
Bentlys: checks 
*** RIVER *** [2d Th Kd 2c] [Ts]
fightingnuns: bets $44
Bentlys: raises $52 to $96
fightingnuns: raises $76 to $172 and is all-in
Bentlys: calls $76
*** SHOW DOWN ***
fightingnuns: shows [Qh Td] (a full house, Tens full of Deuces)
Bentlys: shows [Tc 9s] (a full house, Tens full of Deuces)
fightingnuns collected $199.75 from pot
Bentlys collected $199.75 from pot
*** SUMMARY ***
Total pot $400 | Rake $0.50 
Board [2d Th Kd 2c Ts]
Seat 1: fightingnuns (big blind) showed [Qh Td] and won ($199.75) with a full house, Tens full of Deuces
Seat 2: Bentlys (button) (small blind) showed [Tc 9s] and won ($199.75) with a full house, Tens full of Deuces



PokerStars Game #59893449520:  Hold'em No Limit ($2/$4 USD) - 2011/03/27 13:19:52 ET
Table 'Castor IX' 2-max Seat #1 is the button
Seat 1: fightingnuns ($200 in chips) 
Seat 2: Bentlys ($482.95 in chips) 
fightingnuns: posts small blind $2
Bentlys: posts big blind $4
*** HOLE CARDS ***
Dealt to fightingnuns [2c 4s]
fightingnuns: folds 
Uncalled bet ($2) returned to Bentlys
Bentlys collected $4 from pot
*** SUMMARY ***
Total pot $4 | Rake $0 
Seat 1: fightingnuns (button) (small blind) folded before Flop
Seat 2: Bentlys (big blind) collected ($4)



PokerStars Game #59893455787:  Hold'em No Limit ($2/$4 USD) - 2011/03/27 13:19:58 ET
Table 'Castor IX' 2-max Seat #2 is the button
Seat 1: fightingnuns ($200 in chips) 
Seat 2: Bentlys ($484.95 in chips) 
Bentlys: posts small blind $2
fightingnuns: posts big blind $4
*** HOLE CARDS ***
Dealt to fightingnuns [Jc 7c]
Bentlys: folds 
Uncalled bet ($2) returned to fightingnuns
fightingnuns collected $4 from pot
fightingnuns: doesn't show hand 
*** SUMMARY ***
Total pot $4 | Rake $0 
Seat 1: fightingnuns (big blind) collected ($4)
Seat 2: Bentlys (button) (small blind) folded before Flop



PokerStars Game #59893465515:  Hold'em No Limit ($2/$4 USD) - 2011/03/27 13:20:07 ET
Table 'Castor IX' 2-max Seat #1 is the button
Seat 1: fightingnuns ($202 in chips) 
Seat 2: Bentlys ($482.95 in chips) 
fightingnuns: posts small blind $2
Bentlys: posts big blind $4
*** HOLE CARDS ***
Dealt to fightingnuns [As 4h]
fightingnuns: raises $4 to $8
Bentlys: calls $4
*** FLOP *** [Kc 6c Tc]
Bentlys: checks 
fightingnuns: checks 
*** TURN *** [Kc 6c Tc] [4c]
Bentlys: bets $8
fightingnuns: folds 
Uncalled bet ($8) returned to Bentlys
Bentlys collected $15.50 from pot
*** SUMMARY ***
Total pot $16 | Rake $0.50 
Board [Kc 6c Tc 4c]
Seat 1: fightingnuns (button) (small blind) folded on the Turn
Seat 2: Bentlys (big blind) collected ($15.50)



PokerStars Game #59893493440:  Hold'em No Limit ($2/$4 USD) - 2011/03/27 13:20:35 ET
Table 'Castor IX' 2-max Seat #2 is the button
Seat 1: fightingnuns ($200 in chips) 
Seat 2: Bentlys ($490.45 in chips) 
Bentlys: posts small blind $2
fightingnuns: posts big blind $4
*** HOLE CARDS ***
Dealt to fightingnuns [4d 9d]
Bentlys: raises $16 to $20
fightingnuns: folds 
Uncalled bet ($16) returned to Bentlys
Bentlys collected $8 from pot
*** SUMMARY ***
Total pot $8 | Rake $0 
Seat 1: fightingnuns (big blind) folded before Flop
Seat 2: Bentlys (button) (small blind) collected ($8)



PokerStars Game #59893506882:  Hold'em No Limit ($2/$4 USD) - 2011/03/27 13:20:47 ET
Table 'Castor IX' 2-max Seat #1 is the button
Seat 1: fightingnuns ($200 in chips) 
Seat 2: Bentlys ($494.45 in chips) 
fightingnuns: posts small blind $2
Bentlys: posts big blind $4
*** HOLE CARDS ***
Dealt to fightingnuns [Kc 2s]
fightingnuns: folds 
Uncalled bet ($2) returned to Bentlys
Bentlys collected $4 from pot
*** SUMMARY ***
Total pot $4 | Rake $0 
Seat 1: fightingnuns (button) (small blind) folded before Flop
Seat 2: Bentlys (big blind) collected ($4)



PokerStars Game #59893514020:  Hold'em No Limit ($2/$4 USD) - 2011/03/27 13:20:54 ET
Table 'Castor IX' 2-max Seat #2 is the button
Seat 1: fightingnuns ($200 in chips) 
Seat 2: Bentlys ($496.45 in chips) 
Bentlys: posts small blind $2
fightingnuns: posts big blind $4
*** HOLE CARDS ***
Dealt to fightingnuns [Qs 2s]
Bentlys: folds 
Uncalled bet ($2) returned to fightingnuns
fightingnuns collected $4 from pot
fightingnuns: doesn't show hand 
*** SUMMARY ***
Total pot $4 | Rake $0 
Seat 1: fightingnuns (big blind) collected ($4)
Seat 2: Bentlys (button) (small blind) folded before Flop



PokerStars Game #59893522697:  Hold'em No Limit ($2/$4 USD) - 2011/03/27 13:21:03 ET
Table 'Castor IX' 2-max Seat #1 is the button
Seat 1: fightingnuns ($202 in chips) 
Seat 2: Bentlys ($494.45 in chips) 
fightingnuns: posts small blind $2
Bentlys: posts big blind $4
*** HOLE CARDS ***
Dealt to fightingnuns [8c 4h]
fightingnuns: folds 
Uncalled bet ($2) returned to Bentlys
Bentlys collected $4 from pot
*** SUMMARY ***
Total pot $4 | Rake $0 
Seat 1: fightingnuns (button) (small blind) folded before Flop
Seat 2: Bentlys (big blind) collected ($4)



PokerStars Game #59893528832:  Hold'em No Limit ($2/$4 USD) - 2011/03/27 13:21:09 ET
Table 'Castor IX' 2-max Seat #2 is the button
Seat 1: fightingnuns ($200 in chips) 
Seat 2: Bentlys ($496.45 in chips) 
Bentlys: posts small blind $2
fightingnuns: posts big blind $4
*** HOLE CARDS ***
Dealt to fightingnuns [4d Td]
Bentlys: raises $8 to $12
fightingnuns: folds 
Uncalled bet ($8) returned to Bentlys
Bentlys collected $8 from pot
*** SUMMARY ***
Total pot $8 | Rake $0 
Seat 1: fightingnuns (big blind) folded before Flop
Seat 2: Bentlys (button) (small blind) collected ($8)



PokerStars Game #59893539299:  Hold'em No Limit ($2/$4 USD) - 2011/03/27 13:21:19 ET
Table 'Castor IX' 2-max Seat #1 is the button
Seat 1: fightingnuns ($200 in chips) 
Seat 2: Bentlys ($500.45 in chips) 
fightingnuns: posts small blind $2
Bentlys: posts big blind $4
*** HOLE CARDS ***
Dealt to fightingnuns [6s Tc]
fightingnuns: raises $4 to $8
Bentlys: calls $4
*** FLOP *** [3h Ah Td]
Bentlys: checks 
fightingnuns: checks 
*** TURN *** [3h Ah Td] [2c]
Bentlys: checks 
fightingnuns: checks 
*** RIVER *** [3h Ah Td 2c] [Qs]
Bentlys: checks 
fightingnuns: checks 
*** SHOW DOWN ***
Bentlys: shows [7d Js] (high card Ace)
fightingnuns: shows [6s Tc] (a pair of Tens)
fightingnuns collected $15.50 from pot
*** SUMMARY ***
Total pot $16 | Rake $0.50 
Board [3h Ah Td 2c Qs]
Seat 1: fightingnuns (button) (small blind) showed [6s Tc] and won ($15.50) with a pair of Tens
Seat 2: Bentlys (big blind) showed [7d Js] and lost with high card Ace



PokerStars Game #59893578891:  Hold'em No Limit ($2/$4 USD) - 2011/03/27 13:21:57 ET
Table 'Castor IX' 2-max Seat #2 is the button
Seat 1: fightingnuns ($207.50 in chips) 
Seat 2: Bentlys ($492.45 in chips) 
Bentlys: posts small blind $2
fightingnuns: posts big blind $4
*** HOLE CARDS ***
Dealt to fightingnuns [5s 4d]
Bentlys: raises $8 to $12
fightingnuns: folds 
Uncalled bet ($8) returned to Bentlys
Bentlys collected $8 from pot
*** SUMMARY ***
Total pot $8 | Rake $0 
Seat 1: fightingnuns (big blind) folded before Flop
Seat 2: Bentlys (button) (small blind) collected ($8)



PokerStars Game #59893590815:  Hold'em No Limit ($2/$4 USD) - 2011/03/27 13:22:09 ET
Table 'Castor IX' 2-max Seat #1 is the button
Seat 1: fightingnuns ($203.50 in chips) 
Seat 2: Bentlys ($496.45 in chips) 
fightingnuns: posts small blind $2
Bentlys: posts big blind $4
*** HOLE CARDS ***
Dealt to fightingnuns [9d 5s]
fightingnuns: folds 
Uncalled bet ($2) returned to Bentlys
Bentlys collected $4 from pot
*** SUMMARY ***
Total pot $4 | Rake $0 
Seat 1: fightingnuns (button) (small blind) folded before Flop
Seat 2: Bentlys (big blind) collected ($4)



PokerStars Game #59893597656:  Hold'em No Limit ($2/$4 USD) - 2011/03/27 13:22:16 ET
Table 'Castor IX' 2-max Seat #2 is the button
Seat 1: fightingnuns ($201.50 in chips) 
Seat 2: Bentlys ($498.45 in chips) 
Bentlys: posts small blind $2
fightingnuns: posts big blind $4
*** HOLE CARDS ***
Dealt to fightingnuns [Ac 8c]
Bentlys: raises $12 to $16
fightingnuns: folds 
Uncalled bet ($12) returned to Bentlys
Bentlys collected $8 from pot
*** SUMMARY ***
Total pot $8 | Rake $0 
Seat 1: fightingnuns (big blind) folded before Flop
Seat 2: Bentlys (button) (small blind) collected ($8)



PokerStars Game #59893610893:  Hold'em No Limit ($2/$4 USD) - 2011/03/27 13:22:29 ET
Table 'Castor IX' 2-max Seat #1 is the button
Seat 1: fightingnuns ($200 in chips) 
Seat 2: Bentlys ($502.45 in chips) 
fightingnuns: posts small blind $2
Bentlys: posts big blind $4
*** HOLE CARDS ***
Dealt to fightingnuns [4c 8c]
fightingnuns: raises $4 to $8
Bentlys: calls $4
*** FLOP *** [Kd 3c Qh]
Bentlys: bets $20
fightingnuns: folds 
Uncalled bet ($20) returned to Bentlys
Bentlys collected $15.50 from pot
*** SUMMARY ***
Total pot $16 | Rake $0.50 
Board [Kd 3c Qh]
Seat 1: fightingnuns (button) (small blind) folded on the Flop
Seat 2: Bentlys (big blind) collected ($15.50)



PokerStars Game #59893631457:  Hold'em No Limit ($2/$4 USD) - 2011/03/27 13:22:48 ET
Table 'Castor IX' 2-max Seat #2 is the button
Seat 1: fightingnuns ($200 in chips) 
Seat 2: Bentlys ($509.95 in chips) 
Bentlys: posts small blind $2
fightingnuns: posts big blind $4
*** HOLE CARDS ***
Dealt to fightingnuns [4c Qs]
Bentlys: raises $8 to $12
fightingnuns: folds 
Uncalled bet ($8) returned to Bentlys
Bentlys collected $8 from pot
*** SUMMARY ***
Total pot $8 | Rake $0 
Seat 1: fightingnuns (big blind) folded before Flop
Seat 2: Bentlys (button) (small blind) collected ($8)



PokerStars Game #59893643042:  Hold'em No Limit ($2/$4 USD) - 2011/03/27 13:23:00 ET
Table 'Castor IX' 2-max Seat #1 is the button
Seat 1: fightingnuns ($200 in chips) 
Seat 2: Bentlys ($513.95 in chips) 
fightingnuns: posts small blind $2
Bentlys: posts big blind $4
*** HOLE CARDS ***
Dealt to fightingnuns [7s 7c]
fightingnuns: raises $4 to $8
Bentlys: calls $4
*** FLOP *** [Th 9s Ks]
Bentlys: bets $20
fightingnuns: folds 
Uncalled bet ($20) returned to Bentlys
Bentlys collected $15.50 from pot
*** SUMMARY ***
Total pot $16 | Rake $0.50 
Board [Th 9s Ks]
Seat 1: fightingnuns (button) (small blind) folded on the Flop
Seat 2: Bentlys (big blind) collected ($15.50)



PokerStars Game #59893664403:  Hold'em No Limit ($2/$4 USD) - 2011/03/27 13:23:20 ET
Table 'Castor IX' 2-max Seat #2 is the button
Seat 1: fightingnuns ($200 in chips) 
Seat 2: Bentlys ($521.45 in chips) 
Bentlys: posts small blind $2
fightingnuns: posts big blind $4
*** HOLE CARDS ***
Dealt to fightingnuns [6c Ks]
Bentlys: raises $12 to $16
fightingnuns: folds 
Uncalled bet ($12) returned to Bentlys
Bentlys collected $8 from pot
*** SUMMARY ***
Total pot $8 | Rake $0 
Seat 1: fightingnuns (big blind) folded before Flop
Seat 2: Bentlys (button) (small blind) collected ($8)



PokerStars Game #59893676028:  Hold'em No Limit ($2/$4 USD) - 2011/03/27 13:23:32 ET
Table 'Castor IX' 2-max Seat #1 is the button
Seat 1: fightingnuns ($200 in chips) 
Seat 2: Bentlys ($525.45 in chips) 
fightingnuns: posts small blind $2
Bentlys: posts big blind $4
*** HOLE CARDS ***
Dealt to fightingnuns [9d 8h]
fightingnuns: raises $4 to $8
Bentlys: folds 
Uncalled bet ($4) returned to fightingnuns
fightingnuns collected $8 from pot
fightingnuns: doesn't show hand 
*** SUMMARY ***
Total pot $8 | Rake $0 
Seat 1: fightingnuns (button) (small blind) collected ($8)
Seat 2: Bentlys (big blind) folded before Flop



PokerStars Game #59893686289:  Hold'em No Limit ($2/$4 USD) - 2011/03/27 13:23:42 ET
Table 'Castor IX' 2-max Seat #2 is the button
Seat 1: fightingnuns ($204 in chips) 
Seat 2: Bentlys ($521.45 in chips) 
Bentlys: posts small blind $2
fightingnuns: posts big blind $4
*** HOLE CARDS ***
Dealt to fightingnuns [2h 3c]
Bentlys: raises $8 to $12
fightingnuns: folds 
Uncalled bet ($8) returned to Bentlys
Bentlys collected $8 from pot
*** SUMMARY ***
Total pot $8 | Rake $0 
Seat 1: fightingnuns (big blind) folded before Flop
Seat 2: Bentlys (button) (small blind) collected ($8)



PokerStars Game #59893699245:  Hold'em No Limit ($2/$4 USD) - 2011/03/27 13:23:55 ET
Table 'Castor IX' 2-max Seat #1 is the button
Seat 1: fightingnuns ($200 in chips) 
Seat 2: Bentlys ($525.45 in chips) 
fightingnuns: posts small blind $2
Bentlys: posts big blind $4
*** HOLE CARDS ***
Dealt to fightingnuns [3c Ts]
fightingnuns: folds 
Uncalled bet ($2) returned to Bentlys
Bentlys collected $4 from pot
*** SUMMARY ***
Total pot $4 | Rake $0 
Seat 1: fightingnuns (button) (small blind) folded before Flop
Seat 2: Bentlys (big blind) collected ($4)



PokerStars Game #59893705455:  Hold'em No Limit ($2/$4 USD) - 2011/03/27 13:24:01 ET
Table 'Castor IX' 2-max Seat #2 is the button
Seat 1: fightingnuns ($200 in chips) 
Seat 2: Bentlys ($527.45 in chips) 
Bentlys: posts small blind $2
fightingnuns: posts big blind $4
*** HOLE CARDS ***
Dealt to fightingnuns [3s Js]
Bentlys: calls $2
fightingnuns: raises $12 to $16
Bentlys: calls $12
*** FLOP *** [3d Tc 5h]
fightingnuns: bets $16
Bentlys: calls $16
*** TURN *** [3d Tc 5h] [8h]
fightingnuns: checks 
Bentlys: checks 
*** RIVER *** [3d Tc 5h 8h] [Qs]
fightingnuns: bets $48
Bentlys: folds 
Uncalled bet ($48) returned to fightingnuns
fightingnuns collected $63.50 from pot
fightingnuns: doesn't show hand 
*** SUMMARY ***
Total pot $64 | Rake $0.50 
Board [3d Tc 5h 8h Qs]
Seat 1: fightingnuns (big blind) collected ($63.50)
Seat 2: Bentlys (button) (small blind) folded on the River



PokerStars Game #59893748919:  Hold'em No Limit ($2/$4 USD) - 2011/03/27 13:24:43 ET
Table 'Castor IX' 2-max Seat #1 is the button
Seat 1: fightingnuns ($231.50 in chips) 
Seat 2: Bentlys ($495.45 in chips) 
fightingnuns: posts small blind $2
Bentlys: posts big blind $4
*** HOLE CARDS ***
Dealt to fightingnuns [2s 9c]
fightingnuns: folds 
Uncalled bet ($2) returned to Bentlys
Bentlys collected $4 from pot
*** SUMMARY ***
Total pot $4 | Rake $0 
Seat 1: fightingnuns (button) (small blind) folded before Flop
Seat 2: Bentlys (big blind) collected ($4)



PokerStars Game #59893755579:  Hold'em No Limit ($2/$4 USD) - 2011/03/27 13:24:49 ET
Table 'Castor IX' 2-max Seat #2 is the button
Seat 1: fightingnuns ($229.50 in chips) 
Seat 2: Bentlys ($497.45 in chips) 
Bentlys: posts small blind $2
fightingnuns: posts big blind $4
*** HOLE CARDS ***
Dealt to fightingnuns [4s 6c]
Bentlys: raises $12 to $16
fightingnuns: folds 
Uncalled bet ($12) returned to Bentlys
Bentlys collected $8 from pot
*** SUMMARY ***
Total pot $8 | Rake $0 
Seat 1: fightingnuns (big blind) folded before Flop
Seat 2: Bentlys (button) (small blind) collected ($8)



PokerStars Game #59893767530:  Hold'em No Limit ($2/$4 USD) - 2011/03/27 13:25:01 ET
Table 'Castor IX' 2-max Seat #1 is the button
Seat 1: fightingnuns ($225.50 in chips) 
Seat 2: Bentlys ($501.45 in chips) 
fightingnuns: posts small blind $2
Bentlys: posts big blind $4
*** HOLE CARDS ***
Dealt to fightingnuns [Js Ad]
fightingnuns: raises $4 to $8
Bentlys: raises $12 to $20
fightingnuns: calls $12
*** FLOP *** [4h 2c 5c]
Bentlys: bets $24
fightingnuns: folds 
Uncalled bet ($24) returned to Bentlys
Bentlys collected $39.50 from pot
*** SUMMARY ***
Total pot $40 | Rake $0.50 
Board [4h 2c 5c]
Seat 1: fightingnuns (button) (small blind) folded on the Flop
Seat 2: Bentlys (big blind) collected ($39.50)



PokerStars Game #59893796600:  Hold'em No Limit ($2/$4 USD) - 2011/03/27 13:25:30 ET
Table 'Castor IX' 2-max Seat #2 is the button
Seat 1: fightingnuns ($205.50 in chips) 
Seat 2: Bentlys ($520.95 in chips) 
Bentlys: posts small blind $2
fightingnuns: posts big blind $4
*** HOLE CARDS ***
Dealt to fightingnuns [Ad 8d]
Bentlys: folds 
Uncalled bet ($2) returned to fightingnuns
fightingnuns collected $4 from pot
fightingnuns: doesn't show hand 
*** SUMMARY ***
Total pot $4 | Rake $0 
Seat 1: fightingnuns (big blind) collected ($4)
Seat 2: Bentlys (button) (small blind) folded before Flop



PokerStars Game #59893807562:  Hold'em No Limit ($2/$4 USD) - 2011/03/27 13:25:41 ET
Table 'Castor IX' 2-max Seat #1 is the button
Seat 1: fightingnuns ($207.50 in chips) 
Seat 2: Bentlys ($518.95 in chips) 
fightingnuns: posts small blind $2
Bentlys: posts big blind $4
*** HOLE CARDS ***
Dealt to fightingnuns [3h 7s]
fightingnuns: folds 
Uncalled bet ($2) returned to Bentlys
Bentlys collected $4 from pot
*** SUMMARY ***
Total pot $4 | Rake $0 
Seat 1: fightingnuns (button) (small blind) folded before Flop
Seat 2: Bentlys (big blind) collected ($4)



PokerStars Game #59893814133:  Hold'em No Limit ($2/$4 USD) - 2011/03/27 13:25:47 ET
Table 'Castor IX' 2-max Seat #2 is the button
Seat 1: fightingnuns ($205.50 in chips) 
Seat 2: Bentlys ($520.95 in chips) 
Bentlys: posts small blind $2
fightingnuns: posts big blind $4
*** HOLE CARDS ***
Dealt to fightingnuns [Jd 2d]
Bentlys: raises $12 to $16
fightingnuns: raises $32 to $48
Bentlys: calls $32
*** FLOP *** [Qh 3d Qc]
fightingnuns: bets $48
Bentlys: calls $48
*** TURN *** [Qh 3d Qc] [Ad]
fightingnuns: bets $109.50 and is all-in
Bentlys: folds 
Uncalled bet ($109.50) returned to fightingnuns
fightingnuns collected $191.50 from pot
fightingnuns: doesn't show hand 
*** SUMMARY ***
Total pot $192 | Rake $0.50 
Board [Qh 3d Qc Ad]
Seat 1: fightingnuns (big blind) collected ($191.50)
Seat 2: Bentlys (button) (small blind) folded on the Turn



PokerStars Game #59893847379:  Hold'em No Limit ($2/$4 USD) - 2011/03/27 13:26:19 ET
Table 'Castor IX' 2-max Seat #1 is the button
Seat 1: fightingnuns ($301 in chips) 
Seat 2: Bentlys ($424.95 in chips) 
fightingnuns: posts small blind $2
Bentlys: posts big blind $4
*** HOLE CARDS ***
Dealt to fightingnuns [Ks Js]
fightingnuns: raises $4 to $8
Bentlys: raises $8 to $16
fightingnuns: raises $28 to $44
Bentlys: calls $28
*** FLOP *** [2h 2c 9s]
Bentlys: checks 
fightingnuns: bets $48
Bentlys: calls $48
*** TURN *** [2h 2c 9s] [3c]
Bentlys: bets $332.95 and is all-in
fightingnuns: folds 
Uncalled bet ($332.95) returned to Bentlys
Bentlys collected $183.50 from pot
*** SUMMARY ***
Total pot $184 | Rake $0.50 
Board [2h 2c 9s 3c]
Seat 1: fightingnuns (button) (small blind) folded on the Turn
Seat 2: Bentlys (big blind) collected ($183.50)



PokerStars Game #59893892589:  Hold'em No Limit ($2/$4 USD) - 2011/03/27 13:27:04 ET
Table 'Castor IX' 2-max Seat #2 is the button
Seat 1: fightingnuns ($209 in chips) 
Seat 2: Bentlys ($516.45 in chips) 
Bentlys: posts small blind $2
fightingnuns: posts big blind $4
*** HOLE CARDS ***
Dealt to fightingnuns [4d Kd]
Bentlys: raises $8 to $12
fightingnuns: folds 
Uncalled bet ($8) returned to Bentlys
Bentlys collected $8 from pot
*** SUMMARY ***
Total pot $8 | Rake $0 
Seat 1: fightingnuns (big blind) folded before Flop
Seat 2: Bentlys (button) (small blind) collected ($8)



PokerStars Game #59893904250:  Hold'em No Limit ($2/$4 USD) - 2011/03/27 13:27:15 ET
Table 'Castor IX' 2-max Seat #1 is the button
Seat 1: fightingnuns ($205 in chips) 
Seat 2: Bentlys ($520.45 in chips) 
fightingnuns: posts small blind $2
Bentlys: posts big blind $4
*** HOLE CARDS ***
Dealt to fightingnuns [Jd Qs]
fightingnuns: raises $4 to $8
Bentlys: calls $4
*** FLOP *** [Kc Ac 7h]
Bentlys: bets $28
fightingnuns: folds 
Uncalled bet ($28) returned to Bentlys
Bentlys collected $15.50 from pot
*** SUMMARY ***
Total pot $16 | Rake $0.50 
Board [Kc Ac 7h]
Seat 1: fightingnuns (button) (small blind) folded on the Flop
Seat 2: Bentlys (big blind) collected ($15.50)



PokerStars Game #59893928799:  Hold'em No Limit ($2/$4 USD) - 2011/03/27 13:27:40 ET
Table 'Castor IX' 2-max Seat #2 is the button
Seat 1: fightingnuns ($200 in chips) 
Seat 2: Bentlys ($527.95 in chips) 
Bentlys: posts small blind $2
fightingnuns: posts big blind $4
*** HOLE CARDS ***
Dealt to fightingnuns [5c Ac]
Bentlys: raises $12 to $16
fightingnuns: calls $12
*** FLOP *** [Qd 3d Td]
fightingnuns: checks 
Bentlys: checks 
*** TURN *** [Qd 3d Td] [4d]
fightingnuns: checks 
Bentlys: bets $12
fightingnuns: folds 
Uncalled bet ($12) returned to Bentlys
Bentlys collected $31.50 from pot
*** SUMMARY ***
Total pot $32 | Rake $0.50 
Board [Qd 3d Td 4d]
Seat 1: fightingnuns (big blind) folded on the Turn
Seat 2: Bentlys (button) (small blind) collected ($31.50)



PokerStars Game #59893969634:  Hold'em No Limit ($2/$4 USD) - 2011/03/27 13:28:20 ET
Table 'Castor IX' 2-max Seat #1 is the button
Seat 1: fightingnuns ($200 in chips) 
Seat 2: Bentlys ($543.45 in chips) 
fightingnuns: posts small blind $2
Bentlys: posts big blind $4
*** HOLE CARDS ***
Dealt to fightingnuns [Kd 9c]
fightingnuns: raises $4 to $8
Bentlys: raises $16 to $24
fightingnuns: calls $16
*** FLOP *** [7c Kc Ad]
Bentlys: bets $36
fightingnuns: calls $36
*** TURN *** [7c Kc Ad] [7d]
Bentlys: bets $40
fightingnuns: calls $40
*** RIVER *** [7c Kc Ad 7d] [9h]
Bentlys: checks 
fightingnuns: checks 
*** SHOW DOWN ***
Bentlys: shows [Td Th] (two pair, Tens and Sevens)
fightingnuns: shows [Kd 9c] (two pair, Kings and Nines)
fightingnuns collected $199.50 from pot
*** SUMMARY ***
Total pot $200 | Rake $0.50 
Board [7c Kc Ad 7d 9h]
Seat 1: fightingnuns (button) (small blind) showed [Kd 9c] and won ($199.50) with two pair, Kings and Nines
Seat 2: Bentlys (big blind) showed [Td Th] and lost with two pair, Tens and Sevens



PokerStars Game #59894016725:  Hold'em No Limit ($2/$4 USD) - 2011/03/27 13:29:06 ET
Table 'Castor IX' 2-max Seat #2 is the button
Seat 1: fightingnuns ($299.50 in chips) 
Seat 2: Bentlys ($443.45 in chips) 
Bentlys: posts small blind $2
fightingnuns: posts big blind $4
*** HOLE CARDS ***
Dealt to fightingnuns [4c 3h]
Bentlys: raises $12 to $16
fightingnuns: folds 
Uncalled bet ($12) returned to Bentlys
Bentlys collected $8 from pot
*** SUMMARY ***
Total pot $8 | Rake $0 
Seat 1: fightingnuns (big blind) folded before Flop
Seat 2: Bentlys (button) (small blind) collected ($8)



PokerStars Game #59894028625:  Hold'em No Limit ($2/$4 USD) - 2011/03/27 13:29:18 ET
Table 'Castor IX' 2-max Seat #1 is the button
Seat 1: fightingnuns ($295.50 in chips) 
Seat 2: Bentlys ($447.45 in chips) 
fightingnuns: posts small blind $2
Bentlys: posts big blind $4
*** HOLE CARDS ***
Dealt to fightingnuns [7c 2d]
fightingnuns: folds 
Uncalled bet ($2) returned to Bentlys
Bentlys collected $4 from pot
*** SUMMARY ***
Total pot $4 | Rake $0 
Seat 1: fightingnuns (button) (small blind) folded before Flop
Seat 2: Bentlys (big blind) collected ($4)



PokerStars Game #59894038634:  Hold'em No Limit ($2/$4 USD) - 2011/03/27 13:29:28 ET
Table 'Castor IX' 2-max Seat #2 is the button
Seat 1: fightingnuns ($293.50 in chips) 
Seat 2: Bentlys ($449.45 in chips) 
Bentlys: posts small blind $2
fightingnuns: posts big blind $4
*** HOLE CARDS ***
Dealt to fightingnuns [2h Tc]
Bentlys: folds 
Uncalled bet ($2) returned to fightingnuns
fightingnuns collected $4 from pot
fightingnuns: doesn't show hand 
*** SUMMARY ***
Total pot $4 | Rake $0 
Seat 1: fightingnuns (big blind) collected ($4)
Seat 2: Bentlys (button) (small blind) folded before Flop



PokerStars Game #59894047211:  Hold'em No Limit ($2/$4 USD) - 2011/03/27 13:29:37 ET
Table 'Castor IX' 2-max Seat #1 is the button
Seat 1: fightingnuns ($295.50 in chips) 
Seat 2: Bentlys ($447.45 in chips) 
fightingnuns: posts small blind $2
Bentlys: posts big blind $4
*** HOLE CARDS ***
Dealt to fightingnuns [4s 5d]
fightingnuns: folds 
Uncalled bet ($2) returned to Bentlys
Bentlys collected $4 from pot
*** SUMMARY ***
Total pot $4 | Rake $0 
Seat 1: fightingnuns (button) (small blind) folded before Flop
Seat 2: Bentlys (big blind) collected ($4)



PokerStars Game #59894053141:  Hold'em No Limit ($2/$4 USD) - 2011/03/27 13:29:43 ET
Table 'Castor IX' 2-max Seat #2 is the button
Seat 1: fightingnuns ($293.50 in chips) 
Seat 2: Bentlys ($449.45 in chips) 
Bentlys: posts small blind $2
fightingnuns: posts big blind $4
*** HOLE CARDS ***
Dealt to fightingnuns [Tc 6h]
Bentlys: folds 
Uncalled bet ($2) returned to fightingnuns
fightingnuns collected $4 from pot
fightingnuns: doesn't show hand 
*** SUMMARY ***
Total pot $4 | Rake $0 
Seat 1: fightingnuns (big blind) collected ($4)
Seat 2: Bentlys (button) (small blind) folded before Flop



PokerStars Game #59894061674:  Hold'em No Limit ($2/$4 USD) - 2011/03/27 13:29:51 ET
Table 'Castor IX' 2-max Seat #1 is the button
Seat 1: fightingnuns ($295.50 in chips) 
Seat 2: Bentlys ($447.45 in chips) 
fightingnuns: posts small blind $2
Bentlys: posts big blind $4
*** HOLE CARDS ***
Dealt to fightingnuns [Qd 3s]
fightingnuns: folds 
Uncalled bet ($2) returned to Bentlys
Bentlys collected $4 from pot
*** SUMMARY ***
Total pot $4 | Rake $0 
Seat 1: fightingnuns (button) (small blind) folded before Flop
Seat 2: Bentlys (big blind) collected ($4)



PokerStars Game #59894070585:  Hold'em No Limit ($2/$4 USD) - 2011/03/27 13:29:59 ET
Table 'Castor IX' 2-max Seat #2 is the button
Seat 1: fightingnuns ($293.50 in chips) 
Seat 2: Bentlys ($449.45 in chips) 
Bentlys: posts small blind $2
fightingnuns: posts big blind $4
*** HOLE CARDS ***
Dealt to fightingnuns [Kc 5h]
Bentlys: raises $8 to $12
fightingnuns: folds 
Uncalled bet ($8) returned to Bentlys
Bentlys collected $8 from pot
*** SUMMARY ***
Total pot $8 | Rake $0 
Seat 1: fightingnuns (big blind) folded before Flop
Seat 2: Bentlys (button) (small blind) collected ($8)



PokerStars Game #59894084565:  Hold'em No Limit ($2/$4 USD) - 2011/03/27 13:30:13 ET
Table 'Castor IX' 2-max Seat #1 is the button
Seat 1: fightingnuns ($289.50 in chips) 
Seat 2: Bentlys ($453.45 in chips) 
fightingnuns: posts small blind $2
Bentlys: posts big blind $4
*** HOLE CARDS ***
Dealt to fightingnuns [8s 9s]
fightingnuns: raises $4 to $8
Bentlys: raises $16 to $24
fightingnuns: calls $16
*** FLOP *** [9c Jh 6d]
Bentlys: bets $28
fightingnuns: calls $28
*** TURN *** [9c Jh 6d] [Td]
Bentlys: bets $40
fightingnuns: calls $40
*** RIVER *** [9c Jh 6d Td] [7h]
Bentlys: checks 
fightingnuns: bets $90
Bentlys: calls $90
*** SHOW DOWN ***
fightingnuns: shows [8s 9s] (a straight, Seven to Jack)
Bentlys: mucks hand 
fightingnuns collected $363.50 from pot
*** SUMMARY ***
Total pot $364 | Rake $0.50 
Board [9c Jh 6d Td 7h]
Seat 1: fightingnuns (button) (small blind) showed [8s 9s] and won ($363.50) with a straight, Seven to Jack
Seat 2: Bentlys (big blind) mucked [7d 6h]



PokerStars Game #59894148542:  Hold'em No Limit ($2/$4 USD) - 2011/03/27 13:31:15 ET
Table 'Castor IX' 2-max Seat #2 is the button
Seat 1: fightingnuns ($471 in chips) 
Seat 2: Bentlys ($271.45 in chips) 
Bentlys: posts small blind $2
fightingnuns: posts big blind $4
*** HOLE CARDS ***
Dealt to fightingnuns [Qd 8d]
Bentlys: folds 
Uncalled bet ($2) returned to fightingnuns
fightingnuns collected $4 from pot
fightingnuns: doesn't show hand 
*** SUMMARY ***
Total pot $4 | Rake $0 
Seat 1: fightingnuns (big blind) collected ($4)
Seat 2: Bentlys (button) (small blind) folded before Flop



PokerStars Game #59894157270:  Hold'em No Limit ($2/$4 USD) - 2011/03/27 13:31:24 ET
Table 'Castor IX' 2-max Seat #1 is the button
Seat 1: fightingnuns ($473 in chips) 
Seat 2: Bentlys ($269.45 in chips) 
fightingnuns: posts small blind $2
Bentlys: posts big blind $4
*** HOLE CARDS ***
Dealt to fightingnuns [3s 7c]
fightingnuns: folds 
Uncalled bet ($2) returned to Bentlys
Bentlys collected $4 from pot
*** SUMMARY ***
Total pot $4 | Rake $0 
Seat 1: fightingnuns (button) (small blind) folded before Flop
Seat 2: Bentlys (big blind) collected ($4)



PokerStars Game #59894163355:  Hold'em No Limit ($2/$4 USD) - 2011/03/27 13:31:30 ET
Table 'Castor IX' 2-max Seat #2 is the button
Seat 1: fightingnuns ($471 in chips) 
Seat 2: Bentlys ($271.45 in chips) 
Bentlys: posts small blind $2
fightingnuns: posts big blind $4
*** HOLE CARDS ***
Dealt to fightingnuns [9c 4c]
Bentlys: folds 
Uncalled bet ($2) returned to fightingnuns
fightingnuns collected $4 from pot
fightingnuns: doesn't show hand 
*** SUMMARY ***
Total pot $4 | Rake $0 
Seat 1: fightingnuns (big blind) collected ($4)
Seat 2: Bentlys (button) (small blind) folded before Flop



PokerStars Game #59894172125:  Hold'em No Limit ($2/$4 USD) - 2011/03/27 13:31:38 ET
Table 'Castor IX' 2-max Seat #1 is the button
Seat 1: fightingnuns ($473 in chips) 
Seat 2: Bentlys ($269.45 in chips) 
fightingnuns: posts small blind $2
Bentlys: posts big blind $4
*** HOLE CARDS ***
Dealt to fightingnuns [Th Jh]
fightingnuns: raises $4 to $8
Bentlys: calls $4
*** FLOP *** [4d 2h Ac]
Bentlys: checks 
fightingnuns: bets $12
Bentlys: calls $12
*** TURN *** [4d 2h Ac] [5s]
Bentlys: checks 
fightingnuns: checks 
*** RIVER *** [4d 2h Ac 5s] [Js]
Bentlys: checks 
fightingnuns: checks 
*** SHOW DOWN ***
Bentlys: shows [9h 6c] (high card Ace)
fightingnuns: shows [Th Jh] (a pair of Jacks)
fightingnuns collected $39.50 from pot
*** SUMMARY ***
Total pot $40 | Rake $0.50 
Board [4d 2h Ac 5s Js]
Seat 1: fightingnuns (button) (small blind) showed [Th Jh] and won ($39.50) with a pair of Jacks
Seat 2: Bentlys (big blind) showed [9h 6c] and lost with high card Ace



PokerStars Game #59894214480:  Hold'em No Limit ($2/$4 USD) - 2011/03/27 13:32:19 ET
Table 'Castor IX' 2-max Seat #2 is the button
Seat 1: fightingnuns ($492.50 in chips) 
Seat 2: Bentlys ($249.45 in chips) 
Bentlys: posts small blind $2
fightingnuns: posts big blind $4
*** HOLE CARDS ***
Dealt to fightingnuns [Qd Tc]
Bentlys: raises $8 to $12
fightingnuns: calls $8
*** FLOP *** [7h 7c 4s]
fightingnuns: checks 
Bentlys: bets $16
fightingnuns: folds 
Uncalled bet ($16) returned to Bentlys
Bentlys collected $23.50 from pot
*** SUMMARY ***
Total pot $24 | Rake $0.50 
Board [7h 7c 4s]
Seat 1: fightingnuns (big blind) folded on the Flop
Seat 2: Bentlys (button) (small blind) collected ($23.50)



PokerStars Game #59894236622:  Hold'em No Limit ($2/$4 USD) - 2011/03/27 13:32:41 ET
Table 'Castor IX' 2-max Seat #1 is the button
Seat 1: fightingnuns ($480.50 in chips) 
Seat 2: Bentlys ($260.95 in chips) 
fightingnuns: posts small blind $2
Bentlys: posts big blind $4
*** HOLE CARDS ***
Dealt to fightingnuns [2h Qc]
fightingnuns: folds 
Uncalled bet ($2) returned to Bentlys
Bentlys collected $4 from pot
*** SUMMARY ***
Total pot $4 | Rake $0 
Seat 1: fightingnuns (button) (small blind) folded before Flop
Seat 2: Bentlys (big blind) collected ($4)



PokerStars Game #59894243263:  Hold'em No Limit ($2/$4 USD) - 2011/03/27 13:32:47 ET
Table 'Castor IX' 2-max Seat #2 is the button
Seat 1: fightingnuns ($478.50 in chips) 
Seat 2: Bentlys ($262.95 in chips) 
Bentlys: posts small blind $2
fightingnuns: posts big blind $4
*** HOLE CARDS ***
Dealt to fightingnuns [Qc 9d]
Bentlys: raises $8 to $12
fightingnuns: folds 
Uncalled bet ($8) returned to Bentlys
Bentlys collected $8 from pot
*** SUMMARY ***
Total pot $8 | Rake $0 
Seat 1: fightingnuns (big blind) folded before Flop
Seat 2: Bentlys (button) (small blind) collected ($8)



PokerStars Game #59894257176:  Hold'em No Limit ($2/$4 USD) - 2011/03/27 13:33:01 ET
Table 'Castor IX' 2-max Seat #1 is the button
Seat 1: fightingnuns ($474.50 in chips) 
Seat 2: Bentlys ($266.95 in chips) 
fightingnuns: posts small blind $2
Bentlys: posts big blind $4
*** HOLE CARDS ***
Dealt to fightingnuns [7c 7h]
fightingnuns: raises $4 to $8
Bentlys: raises $12 to $20
fightingnuns: calls $12
*** FLOP *** [8s 4d 6h]
Bentlys: checks 
fightingnuns: checks 
*** TURN *** [8s 4d 6h] [2d]
Bentlys: bets $25
fightingnuns: calls $25
*** RIVER *** [8s 4d 6h 2d] [Jd]
Bentlys: checks 
fightingnuns: checks 
*** SHOW DOWN ***
Bentlys: shows [Kc 2c] (a pair of Deuces)
fightingnuns: shows [7c 7h] (a pair of Sevens)
fightingnuns collected $89.50 from pot
*** SUMMARY ***
Total pot $90 | Rake $0.50 
Board [8s 4d 6h 2d Jd]
Seat 1: fightingnuns (button) (small blind) showed [7c 7h] and won ($89.50) with a pair of Sevens
Seat 2: Bentlys (big blind) showed [Kc 2c] and lost with a pair of Deuces



PokerStars Game #59894307501:  Hold'em No Limit ($2/$4 USD) - 2011/03/27 13:33:49 ET
Table 'Castor IX' 2-max Seat #2 is the button
Seat 1: fightingnuns ($519 in chips) 
Seat 2: Bentlys ($221.95 in chips) 
Bentlys: posts small blind $2
fightingnuns: posts big blind $4
*** HOLE CARDS ***
Dealt to fightingnuns [3d 3s]
Bentlys: raises $12 to $16
fightingnuns: calls $12
*** FLOP *** [2c 6s 9s]
fightingnuns: checks 
Bentlys: checks 
*** TURN *** [2c 6s 9s] [5d]
fightingnuns: checks 
Bentlys: checks 
*** RIVER *** [2c 6s 9s 5d] [8h]
fightingnuns: bets $24
Bentlys: folds 
Uncalled bet ($24) returned to fightingnuns
fightingnuns collected $31.50 from pot
fightingnuns: doesn't show hand 
*** SUMMARY ***
Total pot $32 | Rake $0.50 
Board [2c 6s 9s 5d 8h]
Seat 1: fightingnuns (big blind) collected ($31.50)
Seat 2: Bentlys (button) (small blind) folded on the River



PokerStars Game #59894340992:  Hold'em No Limit ($2/$4 USD) - 2011/03/27 13:34:26 ET
Table 'Castor IX' 2-max Seat #1 is the button
Seat 1: fightingnuns ($534.50 in chips) 
Seat 2: Bentlys ($205.95 in chips) 
fightingnuns: posts small blind $2
Bentlys: posts big blind $4
*** HOLE CARDS ***
Dealt to fightingnuns [9h 7h]
fightingnuns: raises $4 to $8
Bentlys: raises $12 to $20
fightingnuns: calls $12
*** FLOP *** [Kh Tc 7d]
Bentlys: checks 
fightingnuns: checks 
*** TURN *** [Kh Tc 7d] [6d]
Bentlys: bets $40
fightingnuns: folds 
Uncalled bet ($40) returned to Bentlys
Bentlys collected $39.50 from pot
*** SUMMARY ***
Total pot $40 | Rake $0.50 
Board [Kh Tc 7d 6d]
Seat 1: fightingnuns (button) (small blind) folded on the Turn
Seat 2: Bentlys (big blind) collected ($39.50)



PokerStars Game #59894382510:  Hold'em No Limit ($2/$4 USD) - 2011/03/27 13:35:04 ET
Table 'Castor IX' 2-max Seat #2 is the button
Seat 1: fightingnuns ($514.50 in chips) 
Seat 2: Bentlys ($225.45 in chips) 
Bentlys: posts small blind $2
fightingnuns: posts big blind $4
*** HOLE CARDS ***
Dealt to fightingnuns [2h Qc]
Bentlys: raises $4 to $8
fightingnuns: folds 
Uncalled bet ($4) returned to Bentlys
Bentlys collected $8 from pot
*** SUMMARY ***
Total pot $8 | Rake $0 
Seat 1: fightingnuns (big blind) folded before Flop
Seat 2: Bentlys (button) (small blind) collected ($8)



PokerStars Game #59894397679:  Hold'em No Limit ($2/$4 USD) - 2011/03/27 13:35:15 ET
Table 'Castor IX' 2-max Seat #1 is the button
Seat 1: fightingnuns ($510.50 in chips) 
Seat 2: Bentlys ($229.45 in chips) 
fightingnuns: posts small blind $2
Bentlys: posts big blind $4
*** HOLE CARDS ***
Dealt to fightingnuns [8s 2h]
fightingnuns: folds 
Uncalled bet ($2) returned to Bentlys
Bentlys collected $4 from pot
*** SUMMARY ***
Total pot $4 | Rake $0 
Seat 1: fightingnuns (button) (small blind) folded before Flop
Seat 2: Bentlys (big blind) collected ($4)



PokerStars Game #59894404305:  Hold'em No Limit ($2/$4 USD) - 2011/03/27 13:35:22 ET
Table 'Castor IX' 2-max Seat #2 is the button
Seat 1: fightingnuns ($508.50 in chips) 
Seat 2: Bentlys ($231.45 in chips) 
Bentlys: posts small blind $2
fightingnuns: posts big blind $4
*** HOLE CARDS ***
Dealt to fightingnuns [Jh 3c]
Bentlys: raises $12 to $16
fightingnuns: folds 
Uncalled bet ($12) returned to Bentlys
Bentlys collected $8 from pot
*** SUMMARY ***
Total pot $8 | Rake $0 
Seat 1: fightingnuns (big blind) folded before Flop
Seat 2: Bentlys (button) (small blind) collected ($8)



PokerStars Game #59894417516:  Hold'em No Limit ($2/$4 USD) - 2011/03/27 13:35:34 ET
Table 'Castor IX' 2-max Seat #1 is the button
Seat 1: fightingnuns ($504.50 in chips) 
Seat 2: Bentlys ($235.45 in chips) 
fightingnuns: posts small blind $2
Bentlys: posts big blind $4
*** HOLE CARDS ***
Dealt to fightingnuns [4d 3d]
fightingnuns: folds 
Uncalled bet ($2) returned to Bentlys
Bentlys collected $4 from pot
*** SUMMARY ***
Total pot $4 | Rake $0 
Seat 1: fightingnuns (button) (small blind) folded before Flop
Seat 2: Bentlys (big blind) collected ($4)



PokerStars Game #59894424384:  Hold'em No Limit ($2/$4 USD) - 2011/03/27 13:35:41 ET
Table 'Castor IX' 2-max Seat #2 is the button
Seat 1: fightingnuns ($502.50 in chips) 
Seat 2: Bentlys ($237.45 in chips) 
Bentlys: posts small blind $2
fightingnuns: posts big blind $4
*** HOLE CARDS ***
Dealt to fightingnuns [6c 8d]
Bentlys: raises $8 to $12
fightingnuns: folds 
Uncalled bet ($8) returned to Bentlys
Bentlys collected $8 from pot
*** SUMMARY ***
Total pot $8 | Rake $0 
Seat 1: fightingnuns (big blind) folded before Flop
Seat 2: Bentlys (button) (small blind) collected ($8)



PokerStars Game #59894438242:  Hold'em No Limit ($2/$4 USD) - 2011/03/27 13:35:54 ET
Table 'Castor IX' 2-max Seat #1 is the button
Seat 1: fightingnuns ($498.50 in chips) 
Seat 2: Bentlys ($241.45 in chips) 
fightingnuns: posts small blind $2
Bentlys: posts big blind $4
*** HOLE CARDS ***
Dealt to fightingnuns [Qs 8d]
fightingnuns: raises $4 to $8
Bentlys: calls $4
*** FLOP *** [2s 2d 9d]
Bentlys: checks 
fightingnuns: bets $12
Bentlys: folds 
Uncalled bet ($12) returned to fightingnuns
fightingnuns collected $15.50 from pot
fightingnuns: doesn't show hand 
*** SUMMARY ***
Total pot $16 | Rake $0.50 
Board [2s 2d 9d]
Seat 1: fightingnuns (button) (small blind) collected ($15.50)
Seat 2: Bentlys (big blind) folded on the Flop



PokerStars Game #59894469157:  Hold'em No Limit ($2/$4 USD) - 2011/03/27 13:36:23 ET
Table 'Castor IX' 2-max Seat #2 is the button
Seat 1: fightingnuns ($506 in chips) 
Seat 2: Bentlys ($233.45 in chips) 
Bentlys: posts small blind $2
fightingnuns: posts big blind $4
*** HOLE CARDS ***
Dealt to fightingnuns [Ac Jc]
Bentlys: raises $8 to $12
fightingnuns: raises $24 to $36
Bentlys: calls $24
*** FLOP *** [Td 8s 3c]
fightingnuns: bets $44
Bentlys: calls $44
*** TURN *** [Td 8s 3c] [5d]
fightingnuns: checks 
Bentlys: checks 
*** RIVER *** [Td 8s 3c 5d] [9h]
fightingnuns: checks 
Bentlys: checks 
*** SHOW DOWN ***
fightingnuns: shows [Ac Jc] (high card Ace)
Bentlys: shows [9d 7s] (a pair of Nines)
Bentlys collected $159.50 from pot
*** SUMMARY ***
Total pot $160 | Rake $0.50 
Board [Td 8s 3c 5d 9h]
Seat 1: fightingnuns (big blind) showed [Ac Jc] and lost with high card Ace
Seat 2: Bentlys (button) (small blind) showed [9d 7s] and won ($159.50) with a pair of Nines



PokerStars Game #59894512601:  Hold'em No Limit ($2/$4 USD) - 2011/03/27 13:37:03 ET
Table 'Castor IX' 2-max Seat #1 is the button
Seat 1: fightingnuns ($426 in chips) 
Seat 2: Bentlys ($312.95 in chips) 
fightingnuns: posts small blind $2
Bentlys: posts big blind $4
*** HOLE CARDS ***
Dealt to fightingnuns [6d Ad]
fightingnuns: raises $4 to $8
Bentlys: calls $4
*** FLOP *** [8d 6h 9d]
Bentlys: checks 
fightingnuns: bets $12
Bentlys: folds 
Uncalled bet ($12) returned to fightingnuns
fightingnuns collected $15.50 from pot
fightingnuns: doesn't show hand 
*** SUMMARY ***
Total pot $16 | Rake $0.50 
Board [8d 6h 9d]
Seat 1: fightingnuns (button) (small blind) collected ($15.50)
Seat 2: Bentlys (big blind) folded on the Flop



PokerStars Game #59894536847:  Hold'em No Limit ($2/$4 USD) - 2011/03/27 13:37:26 ET
Table 'Castor IX' 2-max Seat #2 is the button
Seat 1: fightingnuns ($433.50 in chips) 
Seat 2: Bentlys ($304.95 in chips) 
Bentlys: posts small blind $2
fightingnuns: posts big blind $4
*** HOLE CARDS ***
Dealt to fightingnuns [Qd 2s]
Bentlys: raises $12 to $16
fightingnuns: folds 
Uncalled bet ($12) returned to Bentlys
Bentlys collected $8 from pot
*** SUMMARY ***
Total pot $8 | Rake $0 
Seat 1: fightingnuns (big blind) folded before Flop
Seat 2: Bentlys (button) (small blind) collected ($8)



PokerStars Game #59894550136:  Hold'em No Limit ($2/$4 USD) - 2011/03/27 13:37:38 ET
Table 'Castor IX' 2-max Seat #1 is the button
Seat 1: fightingnuns ($429.50 in chips) 
Seat 2: Bentlys ($308.95 in chips) 
fightingnuns: posts small blind $2
Bentlys: posts big blind $4
*** HOLE CARDS ***
Dealt to fightingnuns [6d 7s]
fightingnuns: raises $4 to $8
Bentlys: raises $12 to $20
fightingnuns: calls $12
*** FLOP *** [Kc Jd 3d]
Bentlys: checks 
fightingnuns: checks 
*** TURN *** [Kc Jd 3d] [Js]
Bentlys: checks 
fightingnuns: bets $24
Bentlys: folds 
Uncalled bet ($24) returned to fightingnuns
fightingnuns collected $39.50 from pot
fightingnuns: doesn't show hand 
*** SUMMARY ***
Total pot $40 | Rake $0.50 
Board [Kc Jd 3d Js]
Seat 1: fightingnuns (button) (small blind) collected ($39.50)
Seat 2: Bentlys (big blind) folded on the Turn



PokerStars Game #59894591288:  Hold'em No Limit ($2/$4 USD) - 2011/03/27 13:38:17 ET
Table 'Castor IX' 2-max Seat #2 is the button
Seat 1: fightingnuns ($449 in chips) 
Seat 2: Bentlys ($288.95 in chips) 
Bentlys: posts small blind $2
fightingnuns: posts big blind $4
*** HOLE CARDS ***
Dealt to fightingnuns [2s 3d]
Bentlys: raises $12 to $16
fightingnuns: folds 
Uncalled bet ($12) returned to Bentlys
Bentlys collected $8 from pot
*** SUMMARY ***
Total pot $8 | Rake $0 
Seat 1: fightingnuns (big blind) folded before Flop
Seat 2: Bentlys (button) (small blind) collected ($8)



PokerStars Game #59894605882:  Hold'em No Limit ($2/$4 USD) - 2011/03/27 13:38:30 ET
Table 'Castor IX' 2-max Seat #1 is the button
Seat 1: fightingnuns ($445 in chips) 
Seat 2: Bentlys ($292.95 in chips) 
fightingnuns: posts small blind $2
Bentlys: posts big blind $4
*** HOLE CARDS ***
Dealt to fightingnuns [2h 9s]
fightingnuns: folds 
Uncalled bet ($2) returned to Bentlys
Bentlys collected $4 from pot
*** SUMMARY ***
Total pot $4 | Rake $0 
Seat 1: fightingnuns (button) (small blind) folded before Flop
Seat 2: Bentlys (big blind) collected ($4)



PokerStars Game #59894612665:  Hold'em No Limit ($2/$4 USD) - 2011/03/27 13:38:37 ET
Table 'Castor IX' 2-max Seat #2 is the button
Seat 1: fightingnuns ($443 in chips) 
Seat 2: Bentlys ($294.95 in chips) 
Bentlys: posts small blind $2
fightingnuns: posts big blind $4
*** HOLE CARDS ***
Dealt to fightingnuns [7h 4c]
Bentlys: raises $8 to $12
fightingnuns: folds 
Uncalled bet ($8) returned to Bentlys
Bentlys collected $8 from pot
*** SUMMARY ***
Total pot $8 | Rake $0 
Seat 1: fightingnuns (big blind) folded before Flop
Seat 2: Bentlys (button) (small blind) collected ($8)



PokerStars Game #59894624799:  Hold'em No Limit ($2/$4 USD) - 2011/03/27 13:38:48 ET
Table 'Castor IX' 2-max Seat #1 is the button
Seat 1: fightingnuns ($439 in chips) 
Seat 2: Bentlys ($298.95 in chips) 
fightingnuns: posts small blind $2
Bentlys: posts big blind $4
*** HOLE CARDS ***
Dealt to fightingnuns [9d 2s]
fightingnuns: folds 
Uncalled bet ($2) returned to Bentlys
Bentlys collected $4 from pot
*** SUMMARY ***
Total pot $4 | Rake $0 
Seat 1: fightingnuns (button) (small blind) folded before Flop
Seat 2: Bentlys (big blind) collected ($4)



PokerStars Game #59894636859:  Hold'em No Limit ($2/$4 USD) - 2011/03/27 13:38:59 ET
Table 'Castor IX' 2-max Seat #2 is the button
Seat 1: fightingnuns ($437 in chips) 
Seat 2: Bentlys ($300.95 in chips) 
Bentlys: posts small blind $2
fightingnuns: posts big blind $4
*** HOLE CARDS ***
Dealt to fightingnuns [2s 5d]
Bentlys: raises $8 to $12
fightingnuns: folds 
Uncalled bet ($8) returned to Bentlys
Bentlys collected $8 from pot
*** SUMMARY ***
Total pot $8 | Rake $0 
Seat 1: fightingnuns (big blind) folded before Flop
Seat 2: Bentlys (button) (small blind) collected ($8)



PokerStars Game #59894648707:  Hold'em No Limit ($2/$4 USD) - 2011/03/27 13:39:10 ET
Table 'Castor IX' 2-max Seat #1 is the button
Seat 1: fightingnuns ($433 in chips) 
Seat 2: Bentlys ($304.95 in chips) 
fightingnuns: posts small blind $2
Bentlys: posts big blind $4
*** HOLE CARDS ***
Dealt to fightingnuns [2c 8s]
fightingnuns: folds 
Uncalled bet ($2) returned to Bentlys
Bentlys collected $4 from pot
*** SUMMARY ***
Total pot $4 | Rake $0 
Seat 1: fightingnuns (button) (small blind) folded before Flop
Seat 2: Bentlys (big blind) collected ($4)



PokerStars Game #59894655888:  Hold'em No Limit ($2/$4 USD) - 2011/03/27 13:39:17 ET
Table 'Castor IX' 2-max Seat #2 is the button
Seat 1: fightingnuns ($431 in chips) 
Seat 2: Bentlys ($306.95 in chips) 
Bentlys: posts small blind $2
fightingnuns: posts big blind $4
*** HOLE CARDS ***
Dealt to fightingnuns [Qd Qh]
Bentlys: raises $8 to $12
fightingnuns: raises $28 to $40
Bentlys: calls $28
*** FLOP *** [Ac Jc 2c]
fightingnuns: checks 
Bentlys: checks 
*** TURN *** [Ac Jc 2c] [9d]
fightingnuns: bets $44
Bentlys: raises $44 to $88
fightingnuns: calls $44
*** RIVER *** [Ac Jc 2c 9d] [9h]
fightingnuns: checks 
Bentlys: checks 
*** SHOW DOWN ***
fightingnuns: shows [Qd Qh] (two pair, Queens and Nines)
Bentlys: mucks hand 
fightingnuns collected $255.50 from pot
*** SUMMARY ***
Total pot $256 | Rake $0.50 
Board [Ac Jc 2c 9d 9h]
Seat 1: fightingnuns (big blind) showed [Qd Qh] and won ($255.50) with two pair, Queens and Nines
Seat 2: Bentlys (button) (small blind) mucked [Ks 6c]



PokerStars Game #59894701502:  Hold'em No Limit ($2/$4 USD) - 2011/03/27 13:40:00 ET
Table 'Castor IX' 2-max Seat #1 is the button
Seat 1: fightingnuns ($558.50 in chips) 
Seat 2: Bentlys ($178.95 in chips) 
fightingnuns: posts small blind $2
Bentlys: posts big blind $4
*** HOLE CARDS ***
Dealt to fightingnuns [2c 6d]
fightingnuns: folds 
Uncalled bet ($2) returned to Bentlys
Bentlys collected $4 from pot
*** SUMMARY ***
Total pot $4 | Rake $0 
Seat 1: fightingnuns (button) (small blind) folded before Flop
Seat 2: Bentlys (big blind) collected ($4)



PokerStars Game #59894708324:  Hold'em No Limit ($2/$4 USD) - 2011/03/27 13:40:06 ET
Table 'Castor IX' 2-max Seat #2 is the button
Seat 1: fightingnuns ($556.50 in chips) 
Seat 2: Bentlys ($180.95 in chips) 
Bentlys: posts small blind $2
fightingnuns: posts big blind $4
*** HOLE CARDS ***
Dealt to fightingnuns [9h 8s]
Bentlys: raises $8 to $12
fightingnuns: folds 
Uncalled bet ($8) returned to Bentlys
Bentlys collected $8 from pot
*** SUMMARY ***
Total pot $8 | Rake $0 
Seat 1: fightingnuns (big blind) folded before Flop
Seat 2: Bentlys (button) (small blind) collected ($8)



PokerStars Game #59894719640:  Hold'em No Limit ($2/$4 USD) - 2011/03/27 13:40:17 ET
Table 'Castor IX' 2-max Seat #1 is the button
Seat 1: fightingnuns ($552.50 in chips) 
Seat 2: Bentlys ($184.95 in chips) 
fightingnuns: posts small blind $2
Bentlys: posts big blind $4
*** HOLE CARDS ***
Dealt to fightingnuns [3h 6d]
fightingnuns: folds 
Uncalled bet ($2) returned to Bentlys
Bentlys collected $4 from pot
*** SUMMARY ***
Total pot $4 | Rake $0 
Seat 1: fightingnuns (button) (small blind) folded before Flop
Seat 2: Bentlys (big blind) collected ($4)



PokerStars Game #59894727279:  Hold'em No Limit ($2/$4 USD) - 2011/03/27 13:40:24 ET
Table 'Castor IX' 2-max Seat #2 is the button
Seat 1: fightingnuns ($550.50 in chips) 
Seat 2: Bentlys ($186.95 in chips) 
Bentlys: posts small blind $2
fightingnuns: posts big blind $4
*** HOLE CARDS ***
Dealt to fightingnuns [2c 5c]
Bentlys: raises $8 to $12
fightingnuns: folds 
Uncalled bet ($8) returned to Bentlys
Bentlys collected $8 from pot
*** SUMMARY ***
Total pot $8 | Rake $0 
Seat 1: fightingnuns (big blind) folded before Flop
Seat 2: Bentlys (button) (small blind) collected ($8)



PokerStars Game #59894738710:  Hold'em No Limit ($2/$4 USD) - 2011/03/27 13:40:35 ET
Table 'Castor IX' 2-max Seat #1 is the button
Seat 1: fightingnuns ($546.50 in chips) 
Seat 2: Bentlys ($190.95 in chips) 
fightingnuns: posts small blind $2
Bentlys: posts big blind $4
*** HOLE CARDS ***
Dealt to fightingnuns [7c 9c]
fightingnuns: raises $4 to $8
Bentlys: raises $12 to $20
fightingnuns: calls $12
*** FLOP *** [Qh 2d 6d]
Bentlys: checks 
fightingnuns: checks 
*** TURN *** [Qh 2d 6d] [Qd]
Bentlys: bets $28
fightingnuns: folds 
Uncalled bet ($28) returned to Bentlys
Bentlys collected $39.50 from pot
*** SUMMARY ***
Total pot $40 | Rake $0.50 
Board [Qh 2d 6d Qd]
Seat 1: fightingnuns (button) (small blind) folded on the Turn
Seat 2: Bentlys (big blind) collected ($39.50)



PokerStars Game #59894773257:  Hold'em No Limit ($2/$4 USD) - 2011/03/27 13:41:07 ET
Table 'Castor IX' 2-max Seat #2 is the button
Seat 1: fightingnuns ($526.50 in chips) 
Seat 2: Bentlys ($210.45 in chips) 
Bentlys: posts small blind $2
fightingnuns: posts big blind $4
*** HOLE CARDS ***
Dealt to fightingnuns [Js Kh]
Bentlys: raises $8 to $12
fightingnuns: raises $24 to $36
Bentlys: calls $24
*** FLOP *** [Tc 7s 5h]
fightingnuns: checks 
Bentlys: checks 
*** TURN *** [Tc 7s 5h] [4h]
fightingnuns: checks 
Bentlys: checks 
*** RIVER *** [Tc 7s 5h 4h] [Ah]
fightingnuns: bets $48
Bentlys: folds 
Uncalled bet ($48) returned to fightingnuns
fightingnuns collected $71.50 from pot
fightingnuns: doesn't show hand 
*** SUMMARY ***
Total pot $72 | Rake $0.50 
Board [Tc 7s 5h 4h Ah]
Seat 1: fightingnuns (big blind) collected ($71.50)
Seat 2: Bentlys (button) (small blind) folded on the River



PokerStars Game #59894821103:  Hold'em No Limit ($2/$4 USD) - 2011/03/27 13:41:53 ET
Table 'Castor IX' 2-max Seat #1 is the button
Seat 1: fightingnuns ($562 in chips) 
Seat 2: Bentlys ($174.45 in chips) 
fightingnuns: posts small blind $2
Bentlys: posts big blind $4
*** HOLE CARDS ***
Dealt to fightingnuns [5c 6s]
fightingnuns: folds 
Uncalled bet ($2) returned to Bentlys
Bentlys collected $4 from pot
*** SUMMARY ***
Total pot $4 | Rake $0 
Seat 1: fightingnuns (button) (small blind) folded before Flop
Seat 2: Bentlys (big blind) collected ($4)



PokerStars Game #59894828632:  Hold'em No Limit ($2/$4 USD) - 2011/03/27 13:42:00 ET
Table 'Castor IX' 2-max Seat #2 is the button
Seat 1: fightingnuns ($560 in chips) 
Seat 2: Bentlys ($176.45 in chips) 
Bentlys: posts small blind $2
fightingnuns: posts big blind $4
*** HOLE CARDS ***
Dealt to fightingnuns [Kh 8c]
Bentlys: raises $8 to $12
fightingnuns: folds 
Uncalled bet ($8) returned to Bentlys
Bentlys collected $8 from pot
*** SUMMARY ***
Total pot $8 | Rake $0 
Seat 1: fightingnuns (big blind) folded before Flop
Seat 2: Bentlys (button) (small blind) collected ($8)



PokerStars Game #59894840303:  Hold'em No Limit ($2/$4 USD) - 2011/03/27 13:42:11 ET
Table 'Castor IX' 2-max Seat #1 is the button
Seat 1: fightingnuns ($556 in chips) 
Seat 2: Bentlys ($180.45 in chips) 
fightingnuns: posts small blind $2
Bentlys: posts big blind $4
*** HOLE CARDS ***
Dealt to fightingnuns [3c 9c]
fightingnuns: folds 
Uncalled bet ($2) returned to Bentlys
Bentlys collected $4 from pot
*** SUMMARY ***
Total pot $4 | Rake $0 
Seat 1: fightingnuns (button) (small blind) folded before Flop
Seat 2: Bentlys (big blind) collected ($4)



PokerStars Game #59894847009:  Hold'em No Limit ($2/$4 USD) - 2011/03/27 13:42:17 ET
Table 'Castor IX' 2-max Seat #2 is the button
Seat 1: fightingnuns ($554 in chips) 
Seat 2: Bentlys ($182.45 in chips) 
Bentlys: posts small blind $2
fightingnuns: posts big blind $4
*** HOLE CARDS ***
Dealt to fightingnuns [5d 9d]
Bentlys: raises $8 to $12
fightingnuns: folds 
Uncalled bet ($8) returned to Bentlys
Bentlys collected $8 from pot
*** SUMMARY ***
Total pot $8 | Rake $0 
Seat 1: fightingnuns (big blind) folded before Flop
Seat 2: Bentlys (button) (small blind) collected ($8)



PokerStars Game #59894861066:  Hold'em No Limit ($2/$4 USD) - 2011/03/27 13:42:30 ET
Table 'Castor IX' 2-max Seat #1 is the button
Seat 1: fightingnuns ($550 in chips) 
Seat 2: Bentlys ($186.45 in chips) 
fightingnuns: posts small blind $2
Bentlys: posts big blind $4
*** HOLE CARDS ***
Dealt to fightingnuns [Ks 3d]
fightingnuns: folds 
Uncalled bet ($2) returned to Bentlys
Bentlys collected $4 from pot
*** SUMMARY ***
Total pot $4 | Rake $0 
Seat 1: fightingnuns (button) (small blind) folded before Flop
Seat 2: Bentlys (big blind) collected ($4)



PokerStars Game #59894868310:  Hold'em No Limit ($2/$4 USD) - 2011/03/27 13:42:37 ET
Table 'Castor IX' 2-max Seat #2 is the button
Seat 1: fightingnuns ($548 in chips) 
Seat 2: Bentlys ($188.45 in chips) 
Bentlys: posts small blind $2
fightingnuns: posts big blind $4
*** HOLE CARDS ***
Dealt to fightingnuns [2h Jd]
Bentlys: raises $12 to $16
fightingnuns: folds 
Uncalled bet ($12) returned to Bentlys
Bentlys collected $8 from pot
*** SUMMARY ***
Total pot $8 | Rake $0 
Seat 1: fightingnuns (big blind) folded before Flop
Seat 2: Bentlys (button) (small blind) collected ($8)



PokerStars Game #59894880238:  Hold'em No Limit ($2/$4 USD) - 2011/03/27 13:42:48 ET
Table 'Castor IX' 2-max Seat #1 is the button
Seat 1: fightingnuns ($544 in chips) 
Seat 2: Bentlys ($192.45 in chips) 
fightingnuns: posts small blind $2
Bentlys: posts big blind $4
*** HOLE CARDS ***
Dealt to fightingnuns [8d 9s]
fightingnuns: raises $4 to $8
Bentlys: raises $4 to $12
fightingnuns: calls $4
*** FLOP *** [4c Ac 6d]
Bentlys: checks 
fightingnuns: checks 
*** TURN *** [4c Ac 6d] [Ks]
Bentlys: bets $16
fightingnuns: raises $32 to $48
Bentlys: folds 
Uncalled bet ($32) returned to fightingnuns
fightingnuns collected $55.50 from pot
fightingnuns: doesn't show hand 
*** SUMMARY ***
Total pot $56 | Rake $0.50 
Board [4c Ac 6d Ks]
Seat 1: fightingnuns (button) (small blind) collected ($55.50)
Seat 2: Bentlys (big blind) folded on the Turn



PokerStars Game #59894949623:  Hold'em No Limit ($2/$4 USD) - 2011/03/27 13:43:54 ET
Table 'Castor IX' 2-max Seat #2 is the button
Seat 1: fightingnuns ($571.50 in chips) 
Seat 2: Bentlys ($164.45 in chips) 
Bentlys: posts small blind $2
fightingnuns: posts big blind $4
*** HOLE CARDS ***
Dealt to fightingnuns [9h 2c]
Bentlys: raises $8 to $12
fightingnuns: folds 
Uncalled bet ($8) returned to Bentlys
Bentlys collected $8 from pot
*** SUMMARY ***
Total pot $8 | Rake $0 
Seat 1: fightingnuns (big blind) folded before Flop
Seat 2: Bentlys (button) (small blind) collected ($8)



PokerStars Game #59894963178:  Hold'em No Limit ($2/$4 USD) - 2011/03/27 13:44:07 ET
Table 'Castor IX' 2-max Seat #1 is the button
Seat 1: fightingnuns ($567.50 in chips) 
Seat 2: Bentlys ($168.45 in chips) 
fightingnuns: posts small blind $2
Bentlys: posts big blind $4
*** HOLE CARDS ***
Dealt to fightingnuns [9h Qc]
fightingnuns: raises $4 to $8
Bentlys: raises $12 to $20
fightingnuns: calls $12
*** FLOP *** [5s 4c 8h]
Bentlys: checks 
fightingnuns: checks 
*** TURN *** [5s 4c 8h] [6h]
Bentlys: checks 
fightingnuns: checks 
*** RIVER *** [5s 4c 8h 6h] [7h]
Bentlys: checks 
fightingnuns: bets $20
Bentlys: calls $20
*** SHOW DOWN ***
fightingnuns: shows [9h Qc] (a straight, Five to Nine)
Bentlys: shows [9d Jd] (a straight, Five to Nine)
Bentlys collected $39.75 from pot
fightingnuns collected $39.75 from pot
*** SUMMARY ***
Total pot $80 | Rake $0.50 
Board [5s 4c 8h 6h 7h]
Seat 1: fightingnuns (button) (small blind) showed [9h Qc] and won ($39.75) with a straight, Five to Nine
Seat 2: Bentlys (big blind) showed [9d Jd] and won ($39.75) with a straight, Five to Nine



PokerStars Game #59895015565:  Hold'em No Limit ($2/$4 USD) - 2011/03/27 13:44:56 ET
Table 'Castor IX' 2-max Seat #2 is the button
Seat 1: fightingnuns ($567.25 in chips) 
Seat 2: Bentlys ($168.20 in chips) 
Bentlys: posts small blind $2
fightingnuns: posts big blind $4
*** HOLE CARDS ***
Dealt to fightingnuns [6c Ts]
Bentlys: raises $12 to $16
fightingnuns: folds 
Uncalled bet ($12) returned to Bentlys
Bentlys collected $8 from pot
*** SUMMARY ***
Total pot $8 | Rake $0 
Seat 1: fightingnuns (big blind) folded before Flop
Seat 2: Bentlys (button) (small blind) collected ($8)



PokerStars Game #59895027303:  Hold'em No Limit ($2/$4 USD) - 2011/03/27 13:45:07 ET
Table 'Castor IX' 2-max Seat #1 is the button
Seat 1: fightingnuns ($563.25 in chips) 
Seat 2: Bentlys ($172.20 in chips) 
fightingnuns: posts small blind $2
Bentlys: posts big blind $4
*** HOLE CARDS ***
Dealt to fightingnuns [Ac Tc]
fightingnuns: raises $4 to $8
Bentlys: calls $4
*** FLOP *** [Jh Qs Jd]
Bentlys: checks 
fightingnuns: checks 
*** TURN *** [Jh Qs Jd] [5s]
Bentlys: checks 
fightingnuns: checks 
*** RIVER *** [Jh Qs Jd 5s] [6s]
Bentlys: checks 
fightingnuns: checks 
*** SHOW DOWN ***
Bentlys: shows [7h 5d] (two pair, Jacks and Fives)
fightingnuns: mucks hand 
Bentlys collected $15.50 from pot
*** SUMMARY ***
Total pot $16 | Rake $0.50 
Board [Jh Qs Jd 5s 6s]
Seat 1: fightingnuns (button) (small blind) mucked [Ac Tc]
Seat 2: Bentlys (big blind) showed [7h 5d] and won ($15.50) with two pair, Jacks and Fives



PokerStars Game #59895056986:  Hold'em No Limit ($2/$4 USD) - 2011/03/27 13:45:36 ET
Table 'Castor IX' 2-max Seat #2 is the button
Seat 1: fightingnuns ($555.25 in chips) 
Seat 2: Bentlys ($179.70 in chips) 
Bentlys: posts small blind $2
fightingnuns: posts big blind $4
*** HOLE CARDS ***
Dealt to fightingnuns [6c 4h]
Bentlys: raises $4 to $8
fightingnuns: folds 
Uncalled bet ($4) returned to Bentlys
Bentlys collected $8 from pot
*** SUMMARY ***
Total pot $8 | Rake $0 
Seat 1: fightingnuns (big blind) folded before Flop
Seat 2: Bentlys (button) (small blind) collected ($8)



PokerStars Game #59895069313:  Hold'em No Limit ($2/$4 USD) - 2011/03/27 13:45:47 ET
Table 'Castor IX' 2-max Seat #1 is the button
Seat 1: fightingnuns ($551.25 in chips) 
Seat 2: Bentlys ($183.70 in chips) 
fightingnuns: posts small blind $2
Bentlys: posts big blind $4
*** HOLE CARDS ***
Dealt to fightingnuns [4d Th]
fightingnuns: folds 
Uncalled bet ($2) returned to Bentlys
Bentlys collected $4 from pot
*** SUMMARY ***
Total pot $4 | Rake $0 
Seat 1: fightingnuns (button) (small blind) folded before Flop
Seat 2: Bentlys (big blind) collected ($4)



PokerStars Game #59895075657:  Hold'em No Limit ($2/$4 USD) - 2011/03/27 13:45:53 ET
Table 'Castor IX' 2-max Seat #2 is the button
Seat 1: fightingnuns ($549.25 in chips) 
Seat 2: Bentlys ($185.70 in chips) 
Bentlys: posts small blind $2
fightingnuns: posts big blind $4
*** HOLE CARDS ***
Dealt to fightingnuns [8c 9c]
Bentlys: raises $8 to $12
fightingnuns: calls $8
*** FLOP *** [Ts 9s As]
fightingnuns: checks 
Bentlys: checks 
*** TURN *** [Ts 9s As] [Ks]
fightingnuns: bets $12
Bentlys: calls $12
*** RIVER *** [Ts 9s As Ks] [Qh]
fightingnuns: checks 
Bentlys: checks 
*** SHOW DOWN ***
fightingnuns: shows [8c 9c] (a pair of Nines)
Bentlys: shows [Kh 8d] (a pair of Kings)
Bentlys collected $47.50 from pot
*** SUMMARY ***
Total pot $48 | Rake $0.50 
Board [Ts 9s As Ks Qh]
Seat 1: fightingnuns (big blind) showed [8c 9c] and lost with a pair of Nines
Seat 2: Bentlys (button) (small blind) showed [Kh 8d] and won ($47.50) with a pair of Kings



PokerStars Game #59895114796:  Hold'em No Limit ($2/$4 USD) - 2011/03/27 13:46:30 ET
Table 'Castor IX' 2-max Seat #1 is the button
Seat 1: fightingnuns ($525.25 in chips) 
Seat 2: Bentlys ($209.20 in chips) 
fightingnuns: posts small blind $2
Bentlys: posts big blind $4
*** HOLE CARDS ***
Dealt to fightingnuns [4c Kd]
fightingnuns: folds 
Uncalled bet ($2) returned to Bentlys
Bentlys collected $4 from pot
*** SUMMARY ***
Total pot $4 | Rake $0 
Seat 1: fightingnuns (button) (small blind) folded before Flop
Seat 2: Bentlys (big blind) collected ($4)



PokerStars Game #59895122584:  Hold'em No Limit ($2/$4 USD) - 2011/03/27 13:46:37 ET
Table 'Castor IX' 2-max Seat #2 is the button
Seat 1: fightingnuns ($523.25 in chips) 
Seat 2: Bentlys ($211.20 in chips) 
Bentlys: posts small blind $2
fightingnuns: posts big blind $4
*** HOLE CARDS ***
Dealt to fightingnuns [Ah 9d]
Bentlys: raises $16 to $20
fightingnuns: folds 
Uncalled bet ($16) returned to Bentlys
Bentlys collected $8 from pot
*** SUMMARY ***
Total pot $8 | Rake $0 
Seat 1: fightingnuns (big blind) folded before Flop
Seat 2: Bentlys (button) (small blind) collected ($8)



PokerStars Game #59895139153:  Hold'em No Limit ($2/$4 USD) - 2011/03/27 13:46:53 ET
Table 'Castor IX' 2-max Seat #1 is the button
Seat 1: fightingnuns ($519.25 in chips) 
Seat 2: Bentlys ($215.20 in chips) 
fightingnuns: posts small blind $2
Bentlys: posts big blind $4
*** HOLE CARDS ***
Dealt to fightingnuns [6d Ts]
fightingnuns: folds 
Uncalled bet ($2) returned to Bentlys
Bentlys collected $4 from pot
*** SUMMARY ***
Total pot $4 | Rake $0 
Seat 1: fightingnuns (button) (small blind) folded before Flop
Seat 2: Bentlys (big blind) collected ($4)



PokerStars Game #59895145569:  Hold'em No Limit ($2/$4 USD) - 2011/03/27 13:46:59 ET
Table 'Castor IX' 2-max Seat #2 is the button
Seat 1: fightingnuns ($517.25 in chips) 
Seat 2: Bentlys ($217.20 in chips) 
Bentlys: posts small blind $2
fightingnuns: posts big blind $4
*** HOLE CARDS ***
Dealt to fightingnuns [Qs Th]
Bentlys: raises $12 to $16
fightingnuns: calls $12
*** FLOP *** [3h 7h 5d]
fightingnuns: checks 
Bentlys: bets $28
fightingnuns: folds 
Uncalled bet ($28) returned to Bentlys
Bentlys collected $31.50 from pot
*** SUMMARY ***
Total pot $32 | Rake $0.50 
Board [3h 7h 5d]
Seat 1: fightingnuns (big blind) folded on the Flop
Seat 2: Bentlys (button) (small blind) collected ($31.50)



PokerStars Game #59895176091:  Hold'em No Limit ($2/$4 USD) - 2011/03/27 13:47:28 ET
Table 'Castor IX' 2-max Seat #1 is the button
Seat 1: fightingnuns ($501.25 in chips) 
Seat 2: Bentlys ($232.70 in chips) 
fightingnuns: posts small blind $2
Bentlys: posts big blind $4
*** HOLE CARDS ***
Dealt to fightingnuns [7c 6h]
fightingnuns: raises $4 to $8
Bentlys: raises $12 to $20
fightingnuns: folds 
Uncalled bet ($12) returned to Bentlys
Bentlys collected $16 from pot
*** SUMMARY ***
Total pot $16 | Rake $0 
Seat 1: fightingnuns (button) (small blind) folded before Flop
Seat 2: Bentlys (big blind) collected ($16)



PokerStars Game #59895188721:  Hold'em No Limit ($2/$4 USD) - 2011/03/27 13:47:40 ET
Table 'Castor IX' 2-max Seat #2 is the button
Seat 1: fightingnuns ($493.25 in chips) 
Seat 2: Bentlys ($240.70 in chips) 
Bentlys: posts small blind $2
fightingnuns: posts big blind $4
*** HOLE CARDS ***
Dealt to fightingnuns [8c Js]
Bentlys: raises $4 to $8
fightingnuns: folds 
Uncalled bet ($4) returned to Bentlys
Bentlys collected $8 from pot
*** SUMMARY ***
Total pot $8 | Rake $0 
Seat 1: fightingnuns (big blind) folded before Flop
Seat 2: Bentlys (button) (small blind) collected ($8)



PokerStars Game #59895203213:  Hold'em No Limit ($2/$4 USD) - 2011/03/27 13:47:53 ET
Table 'Castor IX' 2-max Seat #1 is the button
Seat 1: fightingnuns ($489.25 in chips) 
Seat 2: Bentlys ($244.70 in chips) 
fightingnuns: posts small blind $2
Bentlys: posts big blind $4
*** HOLE CARDS ***
Dealt to fightingnuns [Ah 3d]
fightingnuns: raises $4 to $8
Bentlys: calls $4
*** FLOP *** [4h Qd 3c]
Bentlys: checks 
fightingnuns: checks 
*** TURN *** [4h Qd 3c] [Kc]
Bentlys: bets $20
fightingnuns: folds 
Uncalled bet ($20) returned to Bentlys
Bentlys collected $15.50 from pot
*** SUMMARY ***
Total pot $16 | Rake $0.50 
Board [4h Qd 3c Kc]
Seat 1: fightingnuns (button) (small blind) folded on the Turn
Seat 2: Bentlys (big blind) collected ($15.50)



PokerStars Game #59895231320:  Hold'em No Limit ($2/$4 USD) - 2011/03/27 13:48:20 ET
Table 'Castor IX' 2-max Seat #2 is the button
Seat 1: fightingnuns ($481.25 in chips) 
Seat 2: Bentlys ($252.20 in chips) 
Bentlys: posts small blind $2
fightingnuns: posts big blind $4
*** HOLE CARDS ***
Dealt to fightingnuns [8h Kd]
Bentlys: raises $4 to $8
fightingnuns: calls $4
*** FLOP *** [7d 2c 3s]
fightingnuns: checks 
Bentlys: bets $28
fightingnuns: folds 
Uncalled bet ($28) returned to Bentlys
Bentlys collected $15.50 from pot
*** SUMMARY ***
Total pot $16 | Rake $0.50 
Board [7d 2c 3s]
Seat 1: fightingnuns (big blind) folded on the Flop
Seat 2: Bentlys (button) (small blind) collected ($15.50)



PokerStars Game #59895256578:  Hold'em No Limit ($2/$4 USD) - 2011/03/27 13:48:43 ET
Table 'Castor IX' 2-max Seat #1 is the button
Seat 1: fightingnuns ($473.25 in chips) 
Seat 2: Bentlys ($259.70 in chips) 
fightingnuns: posts small blind $2
Bentlys: posts big blind $4
*** HOLE CARDS ***
Dealt to fightingnuns [Ac 2c]
fightingnuns: raises $4 to $8
Bentlys: raises $12 to $20
fightingnuns: calls $12
*** FLOP *** [Ah 8h Ts]
Bentlys: bets $48
fightingnuns: calls $48
*** TURN *** [Ah 8h Ts] [Qd]
Bentlys: bets $50
fightingnuns: raises $355.25 to $405.25 and is all-in
Bentlys: calls $141.70 and is all-in
Uncalled bet ($213.55) returned to fightingnuns
*** RIVER *** [Ah 8h Ts Qd] [4c]
*** SHOW DOWN ***
Bentlys: shows [Kh 7h] (high card Ace)
fightingnuns: shows [Ac 2c] (a pair of Aces)
fightingnuns collected $518.90 from pot
*** SUMMARY ***
Total pot $519.40 | Rake $0.50 
Board [Ah 8h Ts Qd 4c]
Seat 1: fightingnuns (button) (small blind) showed [Ac 2c] and won ($518.90) with a pair of Aces
Seat 2: Bentlys (big blind) showed [Kh 7h] and lost with high card Ace



PokerStars Game #59899804477:  Hold'em No Limit ($2/$4 USD) - 2011/03/27 14:55:27 ET
Table 'Castor IX' 2-max Seat #2 is the button
Seat 1: fightingnuns ($732.45 in chips) 
Seat 2: SMS94 ($160 in chips) 
SMS94: posts small blind $2
fightingnuns: posts big blind $4
*** HOLE CARDS ***
Dealt to fightingnuns [8c Ad]
SMS94: folds 
Uncalled bet ($2) returned to fightingnuns
fightingnuns collected $4 from pot
fightingnuns: doesn't show hand 
*** SUMMARY ***
Total pot $4 | Rake $0 
Seat 1: fightingnuns (big blind) collected ($4)
Seat 2: SMS94 (button) (small blind) folded before Flop



PokerStars Game #59899811815:  Hold'em No Limit ($2/$4 USD) - 2011/03/27 14:55:36 ET
Table 'Castor IX' 2-max Seat #1 is the button
Seat 1: fightingnuns ($734.45 in chips) 
Seat 2: SMS94 ($158 in chips) 
fightingnuns: posts small blind $2
SMS94: posts big blind $4
*** HOLE CARDS ***
Dealt to fightingnuns [Ad 3c]
fightingnuns: raises $4 to $8
SMS94: calls $4
*** FLOP *** [4d Tc 4s]
SMS94: checks 
fightingnuns: checks 
*** TURN *** [4d Tc 4s] [Kc]
SMS94: checks 
fightingnuns: checks 
*** RIVER *** [4d Tc 4s Kc] [2d]
SMS94: checks 
fightingnuns: checks 
*** SHOW DOWN ***
SMS94: shows [7s 9d] (a pair of Fours)
fightingnuns: shows [Ad 3c] (a pair of Fours - Ace kicker)
fightingnuns collected $15.50 from pot
*** SUMMARY ***
Total pot $16 | Rake $0.50 
Board [4d Tc 4s Kc 2d]
Seat 1: fightingnuns (button) (small blind) showed [Ad 3c] and won ($15.50) with a pair of Fours
Seat 2: SMS94 (big blind) showed [7s 9d] and lost with a pair of Fours



PokerStars Game #59899841782:  Hold'em No Limit ($2/$4 USD) - 2011/03/27 14:56:14 ET
Table 'Castor IX' 2-max Seat #2 is the button
Seat 1: fightingnuns ($741.95 in chips) 
Seat 2: SMS94 ($150 in chips) 
SMS94: posts small blind $2
fightingnuns: posts big blind $4
*** HOLE CARDS ***
Dealt to fightingnuns [8s Ts]
SMS94: raises $4 to $8
fightingnuns: folds 
Uncalled bet ($4) returned to SMS94
SMS94 collected $8 from pot
*** SUMMARY ***
Total pot $8 | Rake $0 
Seat 1: fightingnuns (big blind) folded before Flop
Seat 2: SMS94 (button) (small blind) collected ($8)



PokerStars Game #59899850660:  Hold'em No Limit ($2/$4 USD) - 2011/03/27 14:56:25 ET
Table 'Castor IX' 2-max Seat #1 is the button
Seat 1: fightingnuns ($737.95 in chips) 
Seat 2: SMS94 ($154 in chips) 
fightingnuns: posts small blind $2
SMS94: posts big blind $4
*** HOLE CARDS ***
Dealt to fightingnuns [2c Ks]
fightingnuns: raises $4 to $8
SMS94: calls $4
*** FLOP *** [7d Jh Qh]
SMS94: bets $12
fightingnuns: folds 
Uncalled bet ($12) returned to SMS94
SMS94 collected $15.50 from pot
*** SUMMARY ***
Total pot $16 | Rake $0.50 
Board [7d Jh Qh]
Seat 1: fightingnuns (button) (small blind) folded on the Flop
Seat 2: SMS94 (big blind) collected ($15.50)



PokerStars Game #59899869485:  Hold'em No Limit ($2/$4 USD) - 2011/03/27 14:56:49 ET
Table 'Castor IX' 2-max Seat #2 is the button
Seat 1: fightingnuns ($729.95 in chips) 
Seat 2: SMS94 ($161.50 in chips) 
SMS94: posts small blind $2
fightingnuns: posts big blind $4
*** HOLE CARDS ***
Dealt to fightingnuns [9s 8s]
SMS94: folds 
Uncalled bet ($2) returned to fightingnuns
fightingnuns collected $4 from pot
fightingnuns: doesn't show hand 
*** SUMMARY ***
Total pot $4 | Rake $0 
Seat 1: fightingnuns (big blind) collected ($4)
Seat 2: SMS94 (button) (small blind) folded before Flop



PokerStars Game #59899879029:  Hold'em No Limit ($2/$4 USD) - 2011/03/27 14:57:00 ET
Table 'Castor IX' 2-max Seat #1 is the button
Seat 1: fightingnuns ($731.95 in chips) 
Seat 2: SMS94 ($159.50 in chips) 
fightingnuns: posts small blind $2
SMS94: posts big blind $4
*** HOLE CARDS ***
Dealt to fightingnuns [Js 4s]
fightingnuns: raises $4 to $8
SMS94: folds 
Uncalled bet ($4) returned to fightingnuns
fightingnuns collected $8 from pot
fightingnuns: doesn't show hand 
*** SUMMARY ***
Total pot $8 | Rake $0 
Seat 1: fightingnuns (button) (small blind) collected ($8)
Seat 2: SMS94 (big blind) folded before Flop



PokerStars Game #59899886870:  Hold'em No Limit ($2/$4 USD) - 2011/03/27 14:57:10 ET
Table 'Castor IX' 2-max Seat #2 is the button
Seat 1: fightingnuns ($735.95 in chips) 
Seat 2: SMS94 ($155.50 in chips) 
SMS94: posts small blind $2
fightingnuns: posts big blind $4
*** HOLE CARDS ***
Dealt to fightingnuns [Td 9h]
SMS94: raises $4 to $8
fightingnuns: calls $4
*** FLOP *** [7d 6c Th]
fightingnuns: bets $12
SMS94: folds 
Uncalled bet ($12) returned to fightingnuns
fightingnuns collected $15.50 from pot
fightingnuns: doesn't show hand 
*** SUMMARY ***
Total pot $16 | Rake $0.50 
Board [7d 6c Th]
Seat 1: fightingnuns (big blind) collected ($15.50)
Seat 2: SMS94 (button) (small blind) folded on the Flop



PokerStars Game #59899904730:  Hold'em No Limit ($2/$4 USD) - 2011/03/27 14:57:32 ET
Table 'Castor IX' 2-max Seat #1 is the button
Seat 1: fightingnuns ($743.45 in chips) 
Seat 2: SMS94 ($147.50 in chips) 
fightingnuns: posts small blind $2
SMS94: posts big blind $4
*** HOLE CARDS ***
Dealt to fightingnuns [3h 5d]
fightingnuns: folds 
Uncalled bet ($2) returned to SMS94
SMS94 collected $4 from pot
*** SUMMARY ***
Total pot $4 | Rake $0 
Seat 1: fightingnuns (button) (small blind) folded before Flop
Seat 2: SMS94 (big blind) collected ($4)



PokerStars Game #59899909856:  Hold'em No Limit ($2/$4 USD) - 2011/03/27 14:57:39 ET
Table 'Castor IX' 2-max Seat #2 is the button
Seat 1: fightingnuns ($741.45 in chips) 
Seat 2: SMS94 ($149.50 in chips) 
SMS94: posts small blind $2
fightingnuns: posts big blind $4
*** HOLE CARDS ***
Dealt to fightingnuns [4c 5d]
SMS94: raises $4 to $8
fightingnuns: folds 
Uncalled bet ($4) returned to SMS94
SMS94 collected $8 from pot
*** SUMMARY ***
Total pot $8 | Rake $0 
Seat 1: fightingnuns (big blind) folded before Flop
Seat 2: SMS94 (button) (small blind) collected ($8)



PokerStars Game #59899918088:  Hold'em No Limit ($2/$4 USD) - 2011/03/27 14:57:49 ET
Table 'Castor IX' 2-max Seat #1 is the button
Seat 1: fightingnuns ($737.45 in chips) 
Seat 2: SMS94 ($153.50 in chips) 
fightingnuns: posts small blind $2
SMS94: posts big blind $4
*** HOLE CARDS ***
Dealt to fightingnuns [3h 7h]
fightingnuns: raises $4 to $8
SMS94: calls $4
*** FLOP *** [Ts 5s Ad]
SMS94: checks 
fightingnuns: checks 
*** TURN *** [Ts 5s Ad] [9c]
SMS94: bets $16
fightingnuns: folds 
Uncalled bet ($16) returned to SMS94
SMS94 collected $15.50 from pot
*** SUMMARY ***
Total pot $16 | Rake $0.50 
Board [Ts 5s Ad 9c]
Seat 1: fightingnuns (button) (small blind) folded on the Turn
Seat 2: SMS94 (big blind) collected ($15.50)



PokerStars Game #59899949088:  Hold'em No Limit ($2/$4 USD) - 2011/03/27 14:58:27 ET
Table 'Castor IX' 2-max Seat #2 is the button
Seat 1: fightingnuns ($729.45 in chips) 
Seat 2: SMS94 ($161 in chips) 
SMS94: posts small blind $2
fightingnuns: posts big blind $4
*** HOLE CARDS ***
Dealt to fightingnuns [8c 6s]
SMS94: raises $4 to $8
fightingnuns: folds 
Uncalled bet ($4) returned to SMS94
SMS94 collected $8 from pot
*** SUMMARY ***
Total pot $8 | Rake $0 
Seat 1: fightingnuns (big blind) folded before Flop
Seat 2: SMS94 (button) (small blind) collected ($8)



PokerStars Game #59899958371:  Hold'em No Limit ($2/$4 USD) - 2011/03/27 14:58:38 ET
Table 'Castor IX' 2-max Seat #1 is the button
Seat 1: fightingnuns ($725.45 in chips) 
Seat 2: SMS94 ($165 in chips) 
fightingnuns: posts small blind $2
SMS94: posts big blind $4
*** HOLE CARDS ***
Dealt to fightingnuns [Ah Kh]
fightingnuns: raises $4 to $8
SMS94: folds 
Uncalled bet ($4) returned to fightingnuns
fightingnuns collected $8 from pot
fightingnuns: doesn't show hand 
*** SUMMARY ***
Total pot $8 | Rake $0 
Seat 1: fightingnuns (button) (small blind) collected ($8)
Seat 2: SMS94 (big blind) folded before Flop



PokerStars Game #59899968671:  Hold'em No Limit ($2/$4 USD) - 2011/03/27 14:58:51 ET
Table 'Castor IX' 2-max Seat #2 is the button
Seat 1: fightingnuns ($729.45 in chips) 
Seat 2: SMS94 ($161 in chips) 
SMS94: posts small blind $2
fightingnuns: posts big blind $4
*** HOLE CARDS ***
Dealt to fightingnuns [As Qd]
SMS94: folds 
Uncalled bet ($2) returned to fightingnuns
fightingnuns collected $4 from pot
fightingnuns: doesn't show hand 
*** SUMMARY ***
Total pot $4 | Rake $0 
Seat 1: fightingnuns (big blind) collected ($4)
Seat 2: SMS94 (button) (small blind) folded before Flop



PokerStars Game #59899973679:  Hold'em No Limit ($2/$4 USD) - 2011/03/27 14:58:57 ET
Table 'Castor IX' 2-max Seat #1 is the button
Seat 1: fightingnuns ($731.45 in chips) 
Seat 2: SMS94 ($159 in chips) 
fightingnuns: posts small blind $2
SMS94: posts big blind $4
*** HOLE CARDS ***
Dealt to fightingnuns [Ts 3c]
fightingnuns: folds 
Uncalled bet ($2) returned to SMS94
SMS94 collected $4 from pot
*** SUMMARY ***
Total pot $4 | Rake $0 
Seat 1: fightingnuns (button) (small blind) folded before Flop
Seat 2: SMS94 (big blind) collected ($4)



PokerStars Game #59899980534:  Hold'em No Limit ($2/$4 USD) - 2011/03/27 14:59:06 ET
Table 'Castor IX' 2-max Seat #2 is the button
Seat 1: fightingnuns ($729.45 in chips) 
Seat 2: SMS94 ($161 in chips) 
SMS94: posts small blind $2
fightingnuns: posts big blind $4
*** HOLE CARDS ***
Dealt to fightingnuns [9c 5d]
SMS94: folds 
Uncalled bet ($2) returned to fightingnuns
fightingnuns collected $4 from pot
fightingnuns: doesn't show hand 
*** SUMMARY ***
Total pot $4 | Rake $0 
Seat 1: fightingnuns (big blind) collected ($4)
Seat 2: SMS94 (button) (small blind) folded before Flop



PokerStars Game #59900297680:  Hold'em No Limit ($2/$4 USD) - 2011/03/27 15:04:09 ET
Table 'Castor IX' 2-max Seat #1 is the button
Seat 1: fightingnuns ($731.45 in chips) 
Seat 2: SMS94 ($200 in chips) 
fightingnuns: posts small blind $2
SMS94: posts big blind $4
*** HOLE CARDS ***
Dealt to fightingnuns [Jh 8d]
fightingnuns: folds 
Uncalled bet ($2) returned to SMS94
SMS94 collected $4 from pot
*** SUMMARY ***
Total pot $4 | Rake $0 
Seat 1: fightingnuns (button) (small blind) folded before Flop
Seat 2: SMS94 (big blind) collected ($4)



PokerStars Game #59833937295:  Hold'em No Limit ($2/$4 USD) - 2011/03/26 12:45:25 ET
Table 'Tucana VI' 2-max Seat #2 is the button
Seat 1: fightingnuns ($200 in chips) 
Seat 2: gotty1988 ($80 in chips) 
gotty1988: posts small blind $2
fightingnuns: posts big blind $4
*** HOLE CARDS ***
Dealt to fightingnuns [Ah As]
gotty1988: calls $2
fightingnuns: raises $8 to $12
gotty1988: calls $8
*** FLOP *** [5c Kh 4c]
fightingnuns: bets $16
gotty1988: raises $52 to $68 and is all-in
fightingnuns: calls $52
*** TURN *** [5c Kh 4c] [Ks]
*** RIVER *** [5c Kh 4c Ks] [4s]
*** SHOW DOWN ***
fightingnuns: shows [Ah As] (two pair, Aces and Kings)
gotty1988: shows [3d 2d] (two pair, Kings and Fours)
fightingnuns collected $159.50 from pot
*** SUMMARY ***
Total pot $160 | Rake $0.50 
Board [5c Kh 4c Ks 4s]
Seat 1: fightingnuns (big blind) showed [Ah As] and won ($159.50) with two pair, Aces and Kings
Seat 2: gotty1988 (button) (small blind) showed [3d 2d] and lost with two pair, Kings and Fours



PokerStars Game #59836458925:  Hold'em No Limit ($2/$4 USD) - 2011/03/26 13:33:57 ET
Table 'Tucana VI' 2-max Seat #1 is the button
Seat 1: fightingnuns ($279.50 in chips) 
Seat 2: GIVESOMEMORE ($80 in chips) 
fightingnuns: posts small blind $2
GIVESOMEMORE: posts big blind $4
*** HOLE CARDS ***
Dealt to fightingnuns [8d Kh]
fightingnuns: raises $4 to $8
GIVESOMEMORE: folds 
Uncalled bet ($4) returned to fightingnuns
fightingnuns collected $8 from pot
fightingnuns: doesn't show hand 
*** SUMMARY ***
Total pot $8 | Rake $0 
Seat 1: fightingnuns (button) (small blind) collected ($8)
Seat 2: GIVESOMEMORE (big blind) folded before Flop



PokerStars Game #59842792416:  Hold'em No Limit ($2/$4 USD) - 2011/03/26 15:21:10 ET
Table 'Tucana VI' 2-max Seat #2 is the button
Seat 1: fightingnuns ($283.50 in chips) 
Seat 2: smmathi ($200 in chips) 
smmathi: posts small blind $2
fightingnuns: posts big blind $4
*** HOLE CARDS ***
Dealt to fightingnuns [2d 5s]
smmathi: raises $6 to $10
fightingnuns: folds 
Uncalled bet ($6) returned to smmathi
smmathi collected $8 from pot
smmathi: doesn't show hand 
*** SUMMARY ***
Total pot $8 | Rake $0 
Seat 1: fightingnuns (big blind) folded before Flop
Seat 2: smmathi (button) (small blind) collected ($8)



PokerStars Game #59847144949:  Hold'em No Limit ($2/$4 USD) - 2011/03/26 16:33:00 ET
Table 'Tucana VI' 2-max Seat #1 is the button
Seat 1: fightingnuns ($279.50 in chips) 
Seat 2: dolobro ($200 in chips) 
fightingnuns: posts small blind $2
dolobro: posts big blind $4
*** HOLE CARDS ***
Dealt to fightingnuns [3h 2c]
fightingnuns: raises $4 to $8
dolobro: calls $4
*** FLOP *** [7s 5d 2s]
dolobro: checks 
fightingnuns: checks 
*** TURN *** [7s 5d 2s] [9s]
dolobro: bets $8
fightingnuns: folds 
Uncalled bet ($8) returned to dolobro
dolobro collected $15.50 from pot
dolobro: doesn't show hand 
*** SUMMARY ***
Total pot $16 | Rake $0.50 
Board [7s 5d 2s 9s]
Seat 1: fightingnuns (button) (small blind) folded on the Turn
Seat 2: dolobro (big blind) collected ($15.50)



PokerStars Game #59847184263:  Hold'em No Limit ($2/$4 USD) - 2011/03/26 16:33:38 ET
Table 'Tucana VI' 2-max Seat #2 is the button
Seat 1: fightingnuns ($271.50 in chips) 
Seat 2: dolobro ($207.50 in chips) 
dolobro: posts small blind $2
fightingnuns: posts big blind $4
*** HOLE CARDS ***
Dealt to fightingnuns [Qh 5c]
dolobro: calls $2
fightingnuns: checks 
*** FLOP *** [2d 4h 7c]
fightingnuns: checks 
dolobro: checks 
*** TURN *** [2d 4h 7c] [8d]
fightingnuns: checks 
dolobro: bets $8
fightingnuns: folds 
Uncalled bet ($8) returned to dolobro
dolobro collected $7.60 from pot
dolobro: doesn't show hand 
*** SUMMARY ***
Total pot $8 | Rake $0.40 
Board [2d 4h 7c 8d]
Seat 1: fightingnuns (big blind) folded on the Turn
Seat 2: dolobro (button) (small blind) collected ($7.60)



PokerStars Game #59847209831:  Hold'em No Limit ($2/$4 USD) - 2011/03/26 16:34:03 ET
Table 'Tucana VI' 2-max Seat #1 is the button
Seat 1: fightingnuns ($267.50 in chips) 
Seat 2: dolobro ($211.10 in chips) 
fightingnuns: posts small blind $2
dolobro: posts big blind $4
*** HOLE CARDS ***
Dealt to fightingnuns [5d 7s]
fightingnuns: raises $4 to $8
dolobro: calls $4
*** FLOP *** [9c Tc Jh]
dolobro: checks 
fightingnuns: bets $12
dolobro: calls $12
*** TURN *** [9c Tc Jh] [Ks]
dolobro: checks 
fightingnuns: bets $28
dolobro: folds 
Uncalled bet ($28) returned to fightingnuns
fightingnuns collected $39.50 from pot
fightingnuns: doesn't show hand 
*** SUMMARY ***
Total pot $40 | Rake $0.50 
Board [9c Tc Jh Ks]
Seat 1: fightingnuns (button) (small blind) collected ($39.50)
Seat 2: dolobro (big blind) folded on the Turn



PokerStars Game #59847239562:  Hold'em No Limit ($2/$4 USD) - 2011/03/26 16:34:32 ET
Table 'Tucana VI' 2-max Seat #2 is the button
Seat 1: fightingnuns ($287 in chips) 
Seat 2: dolobro ($191.10 in chips) 
dolobro: posts small blind $2
fightingnuns: posts big blind $4
*** HOLE CARDS ***
Dealt to fightingnuns [Tc 7h]
dolobro: raises $8 to $12
fightingnuns: folds 
Uncalled bet ($8) returned to dolobro
dolobro collected $8 from pot
dolobro: doesn't show hand 
*** SUMMARY ***
Total pot $8 | Rake $0 
Seat 1: fightingnuns (big blind) folded before Flop
Seat 2: dolobro (button) (small blind) collected ($8)



PokerStars Game #59847249563:  Hold'em No Limit ($2/$4 USD) - 2011/03/26 16:34:42 ET
Table 'Tucana VI' 2-max Seat #1 is the button
Seat 1: fightingnuns ($283 in chips) 
Seat 2: dolobro ($195.10 in chips) 
fightingnuns: posts small blind $2
dolobro: posts big blind $4
*** HOLE CARDS ***
Dealt to fightingnuns [Ac 2c]
fightingnuns: raises $4 to $8
dolobro: calls $4
*** FLOP *** [5c Jd Js]
dolobro: checks 
fightingnuns: checks 
*** TURN *** [5c Jd Js] [3d]
dolobro: checks 
fightingnuns: checks 
*** RIVER *** [5c Jd Js 3d] [Qc]
dolobro: bets $8
fightingnuns: calls $8
*** SHOW DOWN ***
dolobro: shows [3h 6s] (two pair, Jacks and Threes)
fightingnuns: mucks hand 
dolobro collected $31.50 from pot
*** SUMMARY ***
Total pot $32 | Rake $0.50 
Board [5c Jd Js 3d Qc]
Seat 1: fightingnuns (button) (small blind) mucked [Ac 2c]
Seat 2: dolobro (big blind) showed [3h 6s] and won ($31.50) with two pair, Jacks and Threes



PokerStars Game #59847278446:  Hold'em No Limit ($2/$4 USD) - 2011/03/26 16:35:10 ET
Table 'Tucana VI' 2-max Seat #2 is the button
Seat 1: fightingnuns ($267 in chips) 
Seat 2: dolobro ($210.60 in chips) 
dolobro: posts small blind $2
fightingnuns: posts big blind $4
*** HOLE CARDS ***
Dealt to fightingnuns [Qs 5d]
dolobro: raises $4 to $8
fightingnuns: folds 
Uncalled bet ($4) returned to dolobro
dolobro collected $8 from pot
dolobro: doesn't show hand 
*** SUMMARY ***
Total pot $8 | Rake $0 
Seat 1: fightingnuns (big blind) folded before Flop
Seat 2: dolobro (button) (small blind) collected ($8)



PokerStars Game #59847287102:  Hold'em No Limit ($2/$4 USD) - 2011/03/26 16:35:19 ET
Table 'Tucana VI' 2-max Seat #1 is the button
Seat 1: fightingnuns ($263 in chips) 
Seat 2: dolobro ($214.60 in chips) 
fightingnuns: posts small blind $2
dolobro: posts big blind $4
*** HOLE CARDS ***
Dealt to fightingnuns [9d 7d]
fightingnuns: raises $4 to $8
dolobro: calls $4
*** FLOP *** [3d Ac 7h]
dolobro: bets $8
fightingnuns: calls $8
*** TURN *** [3d Ac 7h] [5s]
dolobro: bets $16
fightingnuns: calls $16
*** RIVER *** [3d Ac 7h 5s] [Td]
dolobro: bets $48
fightingnuns: folds 
Uncalled bet ($48) returned to dolobro
dolobro collected $63.50 from pot
dolobro: doesn't show hand 
*** SUMMARY ***
Total pot $64 | Rake $0.50 
Board [3d Ac 7h 5s Td]
Seat 1: fightingnuns (button) (small blind) folded on the River
Seat 2: dolobro (big blind) collected ($63.50)



PokerStars Game #59847326126:  Hold'em No Limit ($2/$4 USD) - 2011/03/26 16:35:57 ET
Table 'Tucana VI' 2-max Seat #2 is the button
Seat 1: fightingnuns ($231 in chips) 
Seat 2: dolobro ($246.10 in chips) 
dolobro: posts small blind $2
fightingnuns: posts big blind $4
*** HOLE CARDS ***
Dealt to fightingnuns [Ah 4d]
dolobro: calls $2
fightingnuns: checks 
*** FLOP *** [9s Ac 5c]
fightingnuns: bets $8
dolobro: folds 
Uncalled bet ($8) returned to fightingnuns
fightingnuns collected $7.60 from pot
fightingnuns: doesn't show hand 
*** SUMMARY ***
Total pot $8 | Rake $0.40 
Board [9s Ac 5c]
Seat 1: fightingnuns (big blind) collected ($7.60)
Seat 2: dolobro (button) (small blind) folded on the Flop



PokerStars Game #59847338567:  Hold'em No Limit ($2/$4 USD) - 2011/03/26 16:36:09 ET
Table 'Tucana VI' 2-max Seat #1 is the button
Seat 1: fightingnuns ($234.60 in chips) 
Seat 2: dolobro ($242.10 in chips) 
fightingnuns: posts small blind $2
dolobro: posts big blind $4
*** HOLE CARDS ***
Dealt to fightingnuns [Qc Qs]
fightingnuns: raises $4 to $8
dolobro: raises $16 to $24
fightingnuns: raises $44 to $68
dolobro: raises $174.10 to $242.10 and is all-in
fightingnuns: calls $166.60 and is all-in
Uncalled bet ($7.50) returned to dolobro
*** FLOP *** [9c Ks 2c]
*** TURN *** [9c Ks 2c] [Jd]
*** RIVER *** [9c Ks 2c Jd] [5s]
*** SHOW DOWN ***
dolobro: shows [Jc Ad] (a pair of Jacks)
fightingnuns: shows [Qc Qs] (a pair of Queens)
fightingnuns collected $468.70 from pot
*** SUMMARY ***
Total pot $469.20 | Rake $0.50 
Board [9c Ks 2c Jd 5s]
Seat 1: fightingnuns (button) (small blind) showed [Qc Qs] and won ($468.70) with a pair of Queens
Seat 2: dolobro (big blind) showed [Jc Ad] and lost with a pair of Jacks



PokerStars Game #59847375334:  Hold'em No Limit ($2/$4 USD) - 2011/03/26 16:36:45 ET
Table 'Tucana VI' 2-max Seat #2 is the button
Seat 1: fightingnuns ($468.70 in chips) 
Seat 2: dolobro ($7.50 in chips) 
dolobro: posts small blind $2
fightingnuns: posts big blind $4
*** HOLE CARDS ***
Dealt to fightingnuns [9d Ts]
dolobro: raises $3.50 to $7.50 and is all-in
fightingnuns: calls $3.50
*** FLOP *** [7c 7d Jc]
*** TURN *** [7c 7d Jc] [3h]
*** RIVER *** [7c 7d Jc 3h] [4h]
*** SHOW DOWN ***
fightingnuns: shows [9d Ts] (a pair of Sevens)
dolobro: shows [2s 5h] (a pair of Sevens - lower kicker)
fightingnuns collected $14.50 from pot
*** SUMMARY ***
Total pot $15 | Rake $0.50 
Board [7c 7d Jc 3h 4h]
Seat 1: fightingnuns (big blind) showed [9d Ts] and won ($14.50) with a pair of Sevens
Seat 2: dolobro (button) (small blind) showed [2s 5h] and lost with a pair of Sevens



PokerStars Game #59848718427:  Hold'em No Limit ($2/$4 USD) - 2011/03/26 17:00:56 ET
Table 'Tucana VI' 2-max Seat #1 is the button
Seat 1: fightingnuns ($475.70 in chips) 
Seat 2: kook1959 ($80 in chips) 
fightingnuns: posts small blind $2
kook1959: posts big blind $4
*** HOLE CARDS ***
Dealt to fightingnuns [2d 7s]
fightingnuns: folds 
Uncalled bet ($2) returned to kook1959
kook1959 collected $4 from pot
*** SUMMARY ***
Total pot $4 | Rake $0 
Seat 1: fightingnuns (button) (small blind) folded before Flop
Seat 2: kook1959 (big blind) collected ($4)



PokerStars Game #59849819385:  Hold'em No Limit ($2/$4 USD) - 2011/03/26 17:19:47 ET
Table 'Tucana VI' 2-max Seat #2 is the button
Seat 1: fightingnuns ($473.70 in chips) 
Seat 2: sp2608 ($200 in chips) 
sp2608: posts small blind $2
fightingnuns: posts big blind $4
*** HOLE CARDS ***
Dealt to fightingnuns [Ts 8h]
sp2608: raises $4 to $8
fightingnuns: folds 
Uncalled bet ($4) returned to sp2608
sp2608 collected $8 from pot
*** SUMMARY ***
Total pot $8 | Rake $0 
Seat 1: fightingnuns (big blind) folded before Flop
Seat 2: sp2608 (button) (small blind) collected ($8)



PokerStars Game #59849829285:  Hold'em No Limit ($2/$4 USD) - 2011/03/26 17:19:57 ET
Table 'Tucana VI' 2-max Seat #1 is the button
Seat 1: fightingnuns ($469.70 in chips) 
Seat 2: sp2608 ($204 in chips) 
fightingnuns: posts small blind $2
sp2608: posts big blind $4
*** HOLE CARDS ***
Dealt to fightingnuns [3s 3d]
fightingnuns: raises $4 to $8
sp2608: raises $196 to $204 and is all-in
fightingnuns: folds 
Uncalled bet ($196) returned to sp2608
sp2608 collected $16 from pot
*** SUMMARY ***
Total pot $16 | Rake $0 
Seat 1: fightingnuns (button) (small blind) folded before Flop
Seat 2: sp2608 (big blind) collected ($16)



PokerStars Game #59849840774:  Hold'em No Limit ($2/$4 USD) - 2011/03/26 17:20:09 ET
Table 'Tucana VI' 2-max Seat #2 is the button
Seat 1: fightingnuns ($461.70 in chips) 
Seat 2: sp2608 ($212 in chips) 
sp2608: posts small blind $2
fightingnuns: posts big blind $4
*** HOLE CARDS ***
Dealt to fightingnuns [6c 7d]
sp2608: raises $4 to $8
fightingnuns: folds 
Uncalled bet ($4) returned to sp2608
sp2608 collected $8 from pot
*** SUMMARY ***
Total pot $8 | Rake $0 
Seat 1: fightingnuns (big blind) folded before Flop
Seat 2: sp2608 (button) (small blind) collected ($8)



PokerStars Game #59849848697:  Hold'em No Limit ($2/$4 USD) - 2011/03/26 17:20:17 ET
Table 'Tucana VI' 2-max Seat #1 is the button
Seat 1: fightingnuns ($457.70 in chips) 
Seat 2: sp2608 ($216 in chips) 
fightingnuns: posts small blind $2
sp2608: posts big blind $4
*** HOLE CARDS ***
Dealt to fightingnuns [Qh 9c]
fightingnuns: raises $4 to $8
sp2608: calls $4
*** FLOP *** [Td Qd 8s]
sp2608: bets $16
fightingnuns: calls $16
*** TURN *** [Td Qd 8s] [8c]
sp2608: bets $60
fightingnuns: folds 
Uncalled bet ($60) returned to sp2608
sp2608 collected $47.50 from pot
*** SUMMARY ***
Total pot $48 | Rake $0.50 
Board [Td Qd 8s 8c]
Seat 1: fightingnuns (button) (small blind) folded on the Turn
Seat 2: sp2608 (big blind) collected ($47.50)



PokerStars Game #59849874225:  Hold'em No Limit ($2/$4 USD) - 2011/03/26 17:20:44 ET
Table 'Tucana VI' 2-max Seat #2 is the button
Seat 1: fightingnuns ($433.70 in chips) 
Seat 2: sp2608 ($239.50 in chips) 
sp2608: posts small blind $2
fightingnuns: posts big blind $4
*** HOLE CARDS ***
Dealt to fightingnuns [Ts 2h]
sp2608: calls $2
fightingnuns: checks 
*** FLOP *** [5h Jc 9s]
fightingnuns: checks 
sp2608: checks 
*** TURN *** [5h Jc 9s] [As]
fightingnuns: checks 
sp2608: bets $8
fightingnuns: folds 
Uncalled bet ($8) returned to sp2608
sp2608 collected $7.60 from pot
*** SUMMARY ***
Total pot $8 | Rake $0.40 
Board [5h Jc 9s As]
Seat 1: fightingnuns (big blind) folded on the Turn
Seat 2: sp2608 (button) (small blind) collected ($7.60)



PokerStars Game #59849892157:  Hold'em No Limit ($2/$4 USD) - 2011/03/26 17:21:03 ET
Table 'Tucana VI' 2-max Seat #1 is the button
Seat 1: fightingnuns ($429.70 in chips) 
Seat 2: sp2608 ($243.10 in chips) 
fightingnuns: posts small blind $2
sp2608: posts big blind $4
*** HOLE CARDS ***
Dealt to fightingnuns [3s 6d]
fightingnuns: folds 
Uncalled bet ($2) returned to sp2608
sp2608 collected $4 from pot
*** SUMMARY ***
Total pot $4 | Rake $0 
Seat 1: fightingnuns (button) (small blind) folded before Flop
Seat 2: sp2608 (big blind) collected ($4)



PokerStars Game #59849898203:  Hold'em No Limit ($2/$4 USD) - 2011/03/26 17:21:09 ET
Table 'Tucana VI' 2-max Seat #2 is the button
Seat 1: fightingnuns ($427.70 in chips) 
Seat 2: sp2608 ($245.10 in chips) 
sp2608: posts small blind $2
fightingnuns: posts big blind $4
*** HOLE CARDS ***
Dealt to fightingnuns [Kc 9s]
sp2608: raises $4 to $8
fightingnuns: calls $4
*** FLOP *** [6s Kd Tc]
fightingnuns: checks 
sp2608: checks 
*** TURN *** [6s Kd Tc] [6c]
fightingnuns: bets $12
sp2608: calls $12
*** RIVER *** [6s Kd Tc 6c] [Jh]
fightingnuns: checks 
sp2608: bets $52
fightingnuns: calls $52
*** SHOW DOWN ***
sp2608: shows [9c Qc] (a straight, Nine to King)
fightingnuns: mucks hand 
sp2608 collected $143.50 from pot
*** SUMMARY ***
Total pot $144 | Rake $0.50 
Board [6s Kd Tc 6c Jh]
Seat 1: fightingnuns (big blind) mucked [Kc 9s]
Seat 2: sp2608 (button) (small blind) showed [9c Qc] and won ($143.50) with a straight, Nine to King



PokerStars Game #59849927510:  Hold'em No Limit ($2/$4 USD) - 2011/03/26 17:21:39 ET
Table 'Tucana VI' 2-max Seat #1 is the button
Seat 1: fightingnuns ($355.70 in chips) 
Seat 2: sp2608 ($316.60 in chips) 
fightingnuns: posts small blind $2
sp2608: posts big blind $4
*** HOLE CARDS ***
Dealt to fightingnuns [3h Tc]
fightingnuns: folds 
Uncalled bet ($2) returned to sp2608
sp2608 collected $4 from pot
*** SUMMARY ***
Total pot $4 | Rake $0 
Seat 1: fightingnuns (button) (small blind) folded before Flop
Seat 2: sp2608 (big blind) collected ($4)



PokerStars Game #59849933029:  Hold'em No Limit ($2/$4 USD) - 2011/03/26 17:21:45 ET
Table 'Tucana VI' 2-max Seat #2 is the button
Seat 1: fightingnuns ($353.70 in chips) 
Seat 2: sp2608 ($318.60 in chips) 
sp2608: posts small blind $2
fightingnuns: posts big blind $4
*** HOLE CARDS ***
Dealt to fightingnuns [6c 2h]
sp2608: calls $2
fightingnuns: checks 
*** FLOP *** [6d 9h 3c]
fightingnuns: checks 
sp2608: bets $8
fightingnuns: calls $8
*** TURN *** [6d 9h 3c] [3d]
fightingnuns: checks 
sp2608: bets $16
fightingnuns: calls $16
*** RIVER *** [6d 9h 3c 3d] [7s]
fightingnuns: checks 
sp2608: bets $52
fightingnuns: folds 
Uncalled bet ($52) returned to sp2608
sp2608 collected $55.50 from pot
*** SUMMARY ***
Total pot $56 | Rake $0.50 
Board [6d 9h 3c 3d 7s]
Seat 1: fightingnuns (big blind) folded on the River
Seat 2: sp2608 (button) (small blind) collected ($55.50)



PokerStars Game #59849969906:  Hold'em No Limit ($2/$4 USD) - 2011/03/26 17:22:22 ET
Table 'Tucana VI' 2-max Seat #1 is the button
Seat 1: fightingnuns ($325.70 in chips) 
Seat 2: sp2608 ($346.10 in chips) 
fightingnuns: posts small blind $2
sp2608: posts big blind $4
*** HOLE CARDS ***
Dealt to fightingnuns [2c 9d]
fightingnuns: folds 
Uncalled bet ($2) returned to sp2608
sp2608 collected $4 from pot
*** SUMMARY ***
Total pot $4 | Rake $0 
Seat 1: fightingnuns (button) (small blind) folded before Flop
Seat 2: sp2608 (big blind) collected ($4)



PokerStars Game #59849975558:  Hold'em No Limit ($2/$4 USD) - 2011/03/26 17:22:28 ET
Table 'Tucana VI' 2-max Seat #2 is the button
Seat 1: fightingnuns ($323.70 in chips) 
Seat 2: sp2608 ($348.10 in chips) 
sp2608: posts small blind $2
fightingnuns: posts big blind $4
*** HOLE CARDS ***
Dealt to fightingnuns [3h Jc]
sp2608: raises $8 to $12
fightingnuns: folds 
Uncalled bet ($8) returned to sp2608
sp2608 collected $8 from pot
*** SUMMARY ***
Total pot $8 | Rake $0 
Seat 1: fightingnuns (big blind) folded before Flop
Seat 2: sp2608 (button) (small blind) collected ($8)



PokerStars Game #59849984310:  Hold'em No Limit ($2/$4 USD) - 2011/03/26 17:22:37 ET
Table 'Tucana VI' 2-max Seat #1 is the button
Seat 1: fightingnuns ($319.70 in chips) 
Seat 2: sp2608 ($352.10 in chips) 
fightingnuns: posts small blind $2
sp2608: posts big blind $4
*** HOLE CARDS ***
Dealt to fightingnuns [Qh Td]
fightingnuns: raises $4 to $8
sp2608: calls $4
*** FLOP *** [7d 5s 4d]
sp2608: bets $12
fightingnuns: folds 
Uncalled bet ($12) returned to sp2608
sp2608 collected $15.50 from pot
*** SUMMARY ***
Total pot $16 | Rake $0.50 
Board [7d 5s 4d]
Seat 1: fightingnuns (button) (small blind) folded on the Flop
Seat 2: sp2608 (big blind) collected ($15.50)



PokerStars Game #59850019328:  Hold'em No Limit ($2/$4 USD) - 2011/03/26 17:23:14 ET
Table 'Tucana VI' 2-max Seat #2 is the button
Seat 1: fightingnuns ($311.70 in chips) 
Seat 2: sp2608 ($359.60 in chips) 
sp2608: posts small blind $2
fightingnuns: posts big blind $4
*** HOLE CARDS ***
Dealt to fightingnuns [9d 9c]
sp2608: raises $4 to $8
fightingnuns: calls $4
*** FLOP *** [3s Ad Ks]
fightingnuns: checks 
sp2608: bets $8
fightingnuns: folds 
Uncalled bet ($8) returned to sp2608
sp2608 collected $15.50 from pot
*** SUMMARY ***
Total pot $16 | Rake $0.50 
Board [3s Ad Ks]
Seat 1: fightingnuns (big blind) folded on the Flop
Seat 2: sp2608 (button) (small blind) collected ($15.50)



PokerStars Game #59850035064:  Hold'em No Limit ($2/$4 USD) - 2011/03/26 17:23:30 ET
Table 'Tucana VI' 2-max Seat #1 is the button
Seat 1: fightingnuns ($303.70 in chips) 
Seat 2: sp2608 ($367.10 in chips) 
fightingnuns: posts small blind $2
sp2608: posts big blind $4
*** HOLE CARDS ***
Dealt to fightingnuns [3d 8d]
fightingnuns: raises $4 to $8
sp2608: calls $4
*** FLOP *** [Ad 6s 7c]
sp2608: bets $12
fightingnuns: calls $12
*** TURN *** [Ad 6s 7c] [Kc]
sp2608: bets $40
fightingnuns: folds 
Uncalled bet ($40) returned to sp2608
sp2608 collected $39.50 from pot
*** SUMMARY ***
Total pot $40 | Rake $0.50 
Board [Ad 6s 7c Kc]
Seat 1: fightingnuns (button) (small blind) folded on the Turn
Seat 2: sp2608 (big blind) collected ($39.50)



PokerStars Game #59850084530:  Hold'em No Limit ($2/$4 USD) - 2011/03/26 17:24:22 ET
Table 'Tucana VI' 2-max Seat #2 is the button
Seat 1: fightingnuns ($283.70 in chips) 
Seat 2: sp2608 ($386.60 in chips) 
sp2608: posts small blind $2
fightingnuns: posts big blind $4
*** HOLE CARDS ***
Dealt to fightingnuns [4d Jd]
sp2608: raises $4 to $8
fightingnuns: folds 
Uncalled bet ($4) returned to sp2608
sp2608 collected $8 from pot
*** SUMMARY ***
Total pot $8 | Rake $0 
Seat 1: fightingnuns (big blind) folded before Flop
Seat 2: sp2608 (button) (small blind) collected ($8)



PokerStars Game #59850092205:  Hold'em No Limit ($2/$4 USD) - 2011/03/26 17:24:30 ET
Table 'Tucana VI' 2-max Seat #1 is the button
Seat 1: fightingnuns ($279.70 in chips) 
Seat 2: sp2608 ($390.60 in chips) 
fightingnuns: posts small blind $2
sp2608: posts big blind $4
*** HOLE CARDS ***
Dealt to fightingnuns [5h 9d]
fightingnuns: folds 
Uncalled bet ($2) returned to sp2608
sp2608 collected $4 from pot
*** SUMMARY ***
Total pot $4 | Rake $0 
Seat 1: fightingnuns (button) (small blind) folded before Flop
Seat 2: sp2608 (big blind) collected ($4)



PokerStars Game #59850097872:  Hold'em No Limit ($2/$4 USD) - 2011/03/26 17:24:36 ET
Table 'Tucana VI' 2-max Seat #2 is the button
Seat 1: fightingnuns ($277.70 in chips) 
Seat 2: sp2608 ($392.60 in chips) 
sp2608: posts small blind $2
fightingnuns: posts big blind $4
*** HOLE CARDS ***
Dealt to fightingnuns [Js Kc]
sp2608: raises $8 to $12
fightingnuns: raises $24 to $36
sp2608: calls $24
*** FLOP *** [Jh Td Qd]
fightingnuns: checks 
sp2608: bets $52
fightingnuns: calls $52
*** TURN *** [Jh Td Qd] [Ac]
fightingnuns: checks 
sp2608: bets $304.60 and is all-in
fightingnuns: calls $189.70 and is all-in
Uncalled bet ($114.90) returned to sp2608
*** RIVER *** [Jh Td Qd Ac] [4h]
*** SHOW DOWN ***
fightingnuns: shows [Js Kc] (a straight, Ten to Ace)
sp2608: shows [Ts Ah] (two pair, Aces and Tens)
fightingnuns collected $554.90 from pot
*** SUMMARY ***
Total pot $555.40 | Rake $0.50 
Board [Jh Td Qd Ac 4h]
Seat 1: fightingnuns (big blind) showed [Js Kc] and won ($554.90) with a straight, Ten to Ace
Seat 2: sp2608 (button) (small blind) showed [Ts Ah] and lost with two pair, Aces and Tens



PokerStars Game #59850136946:  Hold'em No Limit ($2/$4 USD) - 2011/03/26 17:25:17 ET
Table 'Tucana VI' 2-max Seat #1 is the button
Seat 1: fightingnuns ($554.90 in chips) 
Seat 2: sp2608 ($114.90 in chips) 
fightingnuns: posts small blind $2
sp2608: posts big blind $4
*** HOLE CARDS ***
Dealt to fightingnuns [7d 5d]
fightingnuns: calls $2
sp2608: checks 
*** FLOP *** [Jh 9h 4d]
sp2608: bets $12
fightingnuns: folds 
Uncalled bet ($12) returned to sp2608
sp2608 collected $7.60 from pot
*** SUMMARY ***
Total pot $8 | Rake $0.40 
Board [Jh 9h 4d]
Seat 1: fightingnuns (button) (small blind) folded on the Flop
Seat 2: sp2608 (big blind) collected ($7.60)



PokerStars Game #59850149966:  Hold'em No Limit ($2/$4 USD) - 2011/03/26 17:25:30 ET
Table 'Tucana VI' 2-max Seat #2 is the button
Seat 1: fightingnuns ($550.90 in chips) 
Seat 2: sp2608 ($118.50 in chips) 
sp2608: posts small blind $2
fightingnuns: posts big blind $4
*** HOLE CARDS ***
Dealt to fightingnuns [6s Jc]
sp2608: calls $2
fightingnuns: checks 
*** FLOP *** [Ks 4s Td]
fightingnuns: checks 
sp2608: bets $24
fightingnuns: folds 
Uncalled bet ($24) returned to sp2608
sp2608 collected $7.60 from pot
*** SUMMARY ***
Total pot $8 | Rake $0.40 
Board [Ks 4s Td]
Seat 1: fightingnuns (big blind) folded on the Flop
Seat 2: sp2608 (button) (small blind) collected ($7.60)



PokerStars Game #59850165985:  Hold'em No Limit ($2/$4 USD) - 2011/03/26 17:25:47 ET
Table 'Tucana VI' 2-max Seat #1 is the button
Seat 1: fightingnuns ($546.90 in chips) 
Seat 2: sp2608 ($122.10 in chips) 
fightingnuns: posts small blind $2
sp2608: posts big blind $4
*** HOLE CARDS ***
Dealt to fightingnuns [3h Kh]
fightingnuns: calls $2
sp2608: checks 
*** FLOP *** [6d Qd 6s]
sp2608: checks 
fightingnuns: bets $4
sp2608: folds 
Uncalled bet ($4) returned to fightingnuns
fightingnuns collected $7.60 from pot
fightingnuns: doesn't show hand 
*** SUMMARY ***
Total pot $8 | Rake $0.40 
Board [6d Qd 6s]
Seat 1: fightingnuns (button) (small blind) collected ($7.60)
Seat 2: sp2608 (big blind) folded on the Flop



PokerStars Game #59850182006:  Hold'em No Limit ($2/$4 USD) - 2011/03/26 17:26:03 ET
Table 'Tucana VI' 2-max Seat #2 is the button
Seat 1: fightingnuns ($550.50 in chips) 
Seat 2: sp2608 ($118.10 in chips) 
sp2608: posts small blind $2
fightingnuns: posts big blind $4
*** HOLE CARDS ***
Dealt to fightingnuns [5c Jc]
sp2608: calls $2
fightingnuns: checks 
*** FLOP *** [9h Qd 7s]
fightingnuns: checks 
sp2608: bets $16
fightingnuns: folds 
Uncalled bet ($16) returned to sp2608
sp2608 collected $7.60 from pot
*** SUMMARY ***
Total pot $8 | Rake $0.40 
Board [9h Qd 7s]
Seat 1: fightingnuns (big blind) folded on the Flop
Seat 2: sp2608 (button) (small blind) collected ($7.60)



PokerStars Game #59850201739:  Hold'em No Limit ($2/$4 USD) - 2011/03/26 17:26:24 ET
Table 'Tucana VI' 2-max Seat #1 is the button
Seat 1: fightingnuns ($546.50 in chips) 
Seat 2: sp2608 ($121.70 in chips) 
fightingnuns: posts small blind $2
sp2608: posts big blind $4
*** HOLE CARDS ***
Dealt to fightingnuns [9s Ad]
fightingnuns: raises $4 to $8
sp2608: calls $4
*** FLOP *** [As 4s 6d]
sp2608: bets $20
fightingnuns: calls $20
*** TURN *** [As 4s 6d] [6s]
sp2608: bets $93.70 and is all-in
fightingnuns: calls $93.70
*** RIVER *** [As 4s 6d 6s] [Ah]
*** SHOW DOWN ***
sp2608: shows [6h 8h] (a full house, Sixes full of Aces)
fightingnuns: shows [9s Ad] (a full house, Aces full of Sixes)
fightingnuns collected $242.90 from pot
*** SUMMARY ***
Total pot $243.40 | Rake $0.50 
Board [As 4s 6d 6s Ah]
Seat 1: fightingnuns (button) (small blind) showed [9s Ad] and won ($242.90) with a full house, Aces full of Sixes
Seat 2: sp2608 (big blind) showed [6h 8h] and lost with a full house, Sixes full of Aces



PokerStars Game #59850327209:  Hold'em No Limit ($2/$4 USD) - 2011/03/26 17:28:34 ET
Table 'Tucana VI' 2-max Seat #2 is the button
Seat 1: fightingnuns ($667.70 in chips) 
Seat 2: sp2608 ($200 in chips) 
sp2608: posts small blind $2
fightingnuns: posts big blind $4
*** HOLE CARDS ***
Dealt to fightingnuns [9c 2h]
sp2608: raises $4 to $8
fightingnuns: folds 
Uncalled bet ($4) returned to sp2608
sp2608 collected $8 from pot
*** SUMMARY ***
Total pot $8 | Rake $0 
Seat 1: fightingnuns (big blind) folded before Flop
Seat 2: sp2608 (button) (small blind) collected ($8)



PokerStars Game #59850336719:  Hold'em No Limit ($2/$4 USD) - 2011/03/26 17:28:44 ET
Table 'Tucana VI' 2-max Seat #1 is the button
Seat 1: fightingnuns ($663.70 in chips) 
Seat 2: sp2608 ($204 in chips) 
fightingnuns: posts small blind $2
sp2608: posts big blind $4
*** HOLE CARDS ***
Dealt to fightingnuns [Ac Jc]
fightingnuns: raises $4 to $8
sp2608: raises $12 to $20
fightingnuns: calls $12
*** FLOP *** [3d 2h Qh]
sp2608: bets $44
fightingnuns: folds 
Uncalled bet ($44) returned to sp2608
sp2608 collected $39.50 from pot
*** SUMMARY ***
Total pot $40 | Rake $0.50 
Board [3d 2h Qh]
Seat 1: fightingnuns (button) (small blind) folded on the Flop
Seat 2: sp2608 (big blind) collected ($39.50)



PokerStars Game #59850359826:  Hold'em No Limit ($2/$4 USD) - 2011/03/26 17:29:08 ET
Table 'Tucana VI' 2-max Seat #2 is the button
Seat 1: fightingnuns ($643.70 in chips) 
Seat 2: sp2608 ($223.50 in chips) 
sp2608: posts small blind $2
fightingnuns: posts big blind $4
*** HOLE CARDS ***
Dealt to fightingnuns [Qs 4c]
sp2608: calls $2
fightingnuns: checks 
*** FLOP *** [9s As 4s]
fightingnuns: checks 
sp2608: checks 
*** TURN *** [9s As 4s] [6h]
fightingnuns: bets $8
sp2608: calls $8
*** RIVER *** [9s As 4s 6h] [5c]
fightingnuns: bets $20
sp2608: folds 
Uncalled bet ($20) returned to fightingnuns
fightingnuns collected $23.50 from pot
fightingnuns: doesn't show hand 
*** SUMMARY ***
Total pot $24 | Rake $0.50 
Board [9s As 4s 6h 5c]
Seat 1: fightingnuns (big blind) collected ($23.50)
Seat 2: sp2608 (button) (small blind) folded on the River



PokerStars Game #59850381069:  Hold'em No Limit ($2/$4 USD) - 2011/03/26 17:29:31 ET
Table 'Tucana VI' 2-max Seat #1 is the button
Seat 1: fightingnuns ($655.20 in chips) 
Seat 2: sp2608 ($211.50 in chips) 
fightingnuns: posts small blind $2
sp2608: posts big blind $4
*** HOLE CARDS ***
Dealt to fightingnuns [8d 6d]
fightingnuns: raises $4 to $8
sp2608: calls $4
*** FLOP *** [7s Qh 6s]
sp2608: checks 
fightingnuns: checks 
*** TURN *** [7s Qh 6s] [3h]
sp2608: bets $20
fightingnuns: calls $20
*** RIVER *** [7s Qh 6s 3h] [Ac]
sp2608: bets $28
fightingnuns: calls $28
*** SHOW DOWN ***
sp2608: shows [7c 6c] (two pair, Sevens and Sixes)
fightingnuns: mucks hand 
sp2608 collected $111.50 from pot
*** SUMMARY ***
Total pot $112 | Rake $0.50 
Board [7s Qh 6s 3h Ac]
Seat 1: fightingnuns (button) (small blind) mucked [8d 6d]
Seat 2: sp2608 (big blind) showed [7c 6c] and won ($111.50) with two pair, Sevens and Sixes



PokerStars Game #59850408098:  Hold'em No Limit ($2/$4 USD) - 2011/03/26 17:29:59 ET
Table 'Tucana VI' 2-max Seat #2 is the button
Seat 1: fightingnuns ($599.20 in chips) 
Seat 2: sp2608 ($267 in chips) 
sp2608: posts small blind $2
fightingnuns: posts big blind $4
*** HOLE CARDS ***
Dealt to fightingnuns [9s Qc]
sp2608: calls $2
fightingnuns: checks 
*** FLOP *** [5s Jd 5h]
fightingnuns: checks 
sp2608: checks 
*** TURN *** [5s Jd 5h] [2h]
fightingnuns: checks 
sp2608: bets $12
fightingnuns: folds 
Uncalled bet ($12) returned to sp2608
sp2608 collected $7.60 from pot
*** SUMMARY ***
Total pot $8 | Rake $0.40 
Board [5s Jd 5h 2h]
Seat 1: fightingnuns (big blind) folded on the Turn
Seat 2: sp2608 (button) (small blind) collected ($7.60)



PokerStars Game #59850428675:  Hold'em No Limit ($2/$4 USD) - 2011/03/26 17:30:20 ET
Table 'Tucana VI' 2-max Seat #1 is the button
Seat 1: fightingnuns ($595.20 in chips) 
Seat 2: sp2608 ($270.60 in chips) 
fightingnuns: posts small blind $2
sp2608: posts big blind $4
*** HOLE CARDS ***
Dealt to fightingnuns [Js 9d]
fightingnuns: raises $4 to $8
sp2608: calls $4
*** FLOP *** [6d 3h Tc]
sp2608: bets $16
fightingnuns: folds 
Uncalled bet ($16) returned to sp2608
sp2608 collected $15.50 from pot
*** SUMMARY ***
Total pot $16 | Rake $0.50 
Board [6d 3h Tc]
Seat 1: fightingnuns (button) (small blind) folded on the Flop
Seat 2: sp2608 (big blind) collected ($15.50)



PokerStars Game #59850443040:  Hold'em No Limit ($2/$4 USD) - 2011/03/26 17:30:35 ET
Table 'Tucana VI' 2-max Seat #2 is the button
Seat 1: fightingnuns ($587.20 in chips) 
Seat 2: sp2608 ($278.10 in chips) 
sp2608: posts small blind $2
fightingnuns: posts big blind $4
*** HOLE CARDS ***
Dealt to fightingnuns [2h 5d]
sp2608: folds 
Uncalled bet ($2) returned to fightingnuns
fightingnuns collected $4 from pot
fightingnuns: doesn't show hand 
*** SUMMARY ***
Total pot $4 | Rake $0 
Seat 1: fightingnuns (big blind) collected ($4)
Seat 2: sp2608 (button) (small blind) folded before Flop



PokerStars Game #59850449271:  Hold'em No Limit ($2/$4 USD) - 2011/03/26 17:30:42 ET
Table 'Tucana VI' 2-max Seat #1 is the button
Seat 1: fightingnuns ($589.20 in chips) 
Seat 2: sp2608 ($276.10 in chips) 
fightingnuns: posts small blind $2
sp2608: posts big blind $4
*** HOLE CARDS ***
Dealt to fightingnuns [7c Th]
fightingnuns: raises $4 to $8
sp2608: folds 
Uncalled bet ($4) returned to fightingnuns
fightingnuns collected $8 from pot
fightingnuns: doesn't show hand 
*** SUMMARY ***
Total pot $8 | Rake $0 
Seat 1: fightingnuns (button) (small blind) collected ($8)
Seat 2: sp2608 (big blind) folded before Flop



PokerStars Game #59850456808:  Hold'em No Limit ($2/$4 USD) - 2011/03/26 17:30:50 ET
Table 'Tucana VI' 2-max Seat #2 is the button
Seat 1: fightingnuns ($593.20 in chips) 
Seat 2: sp2608 ($272.10 in chips) 
sp2608: posts small blind $2
fightingnuns: posts big blind $4
*** HOLE CARDS ***
Dealt to fightingnuns [8h 8d]
sp2608: folds 
Uncalled bet ($2) returned to fightingnuns
fightingnuns collected $4 from pot
fightingnuns: doesn't show hand 
*** SUMMARY ***
Total pot $4 | Rake $0 
Seat 1: fightingnuns (big blind) collected ($4)
Seat 2: sp2608 (button) (small blind) folded before Flop



PokerStars Game #59850462499:  Hold'em No Limit ($2/$4 USD) - 2011/03/26 17:30:56 ET
Table 'Tucana VI' 2-max Seat #1 is the button
Seat 1: fightingnuns ($595.20 in chips) 
Seat 2: sp2608 ($270.10 in chips) 
fightingnuns: posts small blind $2
sp2608: posts big blind $4
*** HOLE CARDS ***
Dealt to fightingnuns [3c 6s]
fightingnuns: folds 
Uncalled bet ($2) returned to sp2608
sp2608 collected $4 from pot
*** SUMMARY ***
Total pot $4 | Rake $0 
Seat 1: fightingnuns (button) (small blind) folded before Flop
Seat 2: sp2608 (big blind) collected ($4)



PokerStars Game #59850467911:  Hold'em No Limit ($2/$4 USD) - 2011/03/26 17:31:01 ET
Table 'Tucana VI' 2-max Seat #2 is the button
Seat 1: fightingnuns ($593.20 in chips) 
Seat 2: sp2608 ($272.10 in chips) 
sp2608: posts small blind $2
fightingnuns: posts big blind $4
*** HOLE CARDS ***
Dealt to fightingnuns [9s Ac]
sp2608: raises $4 to $8
fightingnuns: calls $4
*** FLOP *** [7h 6d Qc]
fightingnuns: checks 
sp2608: checks 
*** TURN *** [7h 6d Qc] [8c]
fightingnuns: bets $12
sp2608: calls $12
*** RIVER *** [7h 6d Qc 8c] [2c]
fightingnuns: checks 
sp2608: checks 
*** SHOW DOWN ***
fightingnuns: shows [9s Ac] (high card Ace)
sp2608: shows [Jd 8d] (a pair of Eights)
sp2608 collected $39.50 from pot
*** SUMMARY ***
Total pot $40 | Rake $0.50 
Board [7h 6d Qc 8c 2c]
Seat 1: fightingnuns (big blind) showed [9s Ac] and lost with high card Ace
Seat 2: sp2608 (button) (small blind) showed [Jd 8d] and won ($39.50) with a pair of Eights



PokerStars Game #59850490503:  Hold'em No Limit ($2/$4 USD) - 2011/03/26 17:31:25 ET
Table 'Tucana VI' 2-max Seat #1 is the button
Seat 1: fightingnuns ($573.20 in chips) 
Seat 2: sp2608 ($291.60 in chips) 
fightingnuns: posts small blind $2
sp2608: posts big blind $4
*** HOLE CARDS ***
Dealt to fightingnuns [Qc Ac]
fightingnuns: raises $4 to $8
sp2608: calls $4
*** FLOP *** [7s Kd 7h]
sp2608: checks 
fightingnuns: checks 
*** TURN *** [7s Kd 7h] [Ks]
sp2608: bets $4
fightingnuns: calls $4
*** RIVER *** [7s Kd 7h Ks] [3d]
sp2608: bets $4
fightingnuns: calls $4
*** SHOW DOWN ***
sp2608: shows [Js Qh] (two pair, Kings and Sevens)
fightingnuns: shows [Qc Ac] (two pair, Kings and Sevens - Ace kicker)
fightingnuns collected $31.50 from pot
*** SUMMARY ***
Total pot $32 | Rake $0.50 
Board [7s Kd 7h Ks 3d]
Seat 1: fightingnuns (button) (small blind) showed [Qc Ac] and won ($31.50) with two pair, Kings and Sevens
Seat 2: sp2608 (big blind) showed [Js Qh] and lost with two pair, Kings and Sevens



PokerStars Game #59850517436:  Hold'em No Limit ($2/$4 USD) - 2011/03/26 17:31:53 ET
Table 'Tucana VI' 2-max Seat #2 is the button
Seat 1: fightingnuns ($588.70 in chips) 
Seat 2: sp2608 ($275.60 in chips) 
sp2608: posts small blind $2
fightingnuns: posts big blind $4
*** HOLE CARDS ***
Dealt to fightingnuns [6h Ah]
sp2608: calls $2
fightingnuns: raises $12 to $16
sp2608: calls $12
*** FLOP *** [5d 3h 7c]
fightingnuns: bets $20
sp2608: folds 
Uncalled bet ($20) returned to fightingnuns
fightingnuns collected $31.50 from pot
fightingnuns: doesn't show hand 
*** SUMMARY ***
Total pot $32 | Rake $0.50 
Board [5d 3h 7c]
Seat 1: fightingnuns (big blind) collected ($31.50)
Seat 2: sp2608 (button) (small blind) folded on the Flop



PokerStars Game #59850534460:  Hold'em No Limit ($2/$4 USD) - 2011/03/26 17:32:10 ET
Table 'Tucana VI' 2-max Seat #1 is the button
Seat 1: fightingnuns ($604.20 in chips) 
Seat 2: sp2608 ($259.60 in chips) 
fightingnuns: posts small blind $2
sp2608: posts big blind $4
*** HOLE CARDS ***
Dealt to fightingnuns [4d 7s]
fightingnuns: folds 
Uncalled bet ($2) returned to sp2608
sp2608 collected $4 from pot
*** SUMMARY ***
Total pot $4 | Rake $0 
Seat 1: fightingnuns (button) (small blind) folded before Flop
Seat 2: sp2608 (big blind) collected ($4)



PokerStars Game #59850539839:  Hold'em No Limit ($2/$4 USD) - 2011/03/26 17:32:16 ET
Table 'Tucana VI' 2-max Seat #2 is the button
Seat 1: fightingnuns ($602.20 in chips) 
Seat 2: sp2608 ($261.60 in chips) 
sp2608: posts small blind $2
fightingnuns: posts big blind $4
*** HOLE CARDS ***
Dealt to fightingnuns [Kd Th]
sp2608: raises $4 to $8
fightingnuns: calls $4
*** FLOP *** [8h As 3d]
fightingnuns: checks 
sp2608: bets $8
fightingnuns: folds 
Uncalled bet ($8) returned to sp2608
sp2608 collected $15.50 from pot
*** SUMMARY ***
Total pot $16 | Rake $0.50 
Board [8h As 3d]
Seat 1: fightingnuns (big blind) folded on the Flop
Seat 2: sp2608 (button) (small blind) collected ($15.50)



PokerStars Game #59850558498:  Hold'em No Limit ($2/$4 USD) - 2011/03/26 17:32:36 ET
Table 'Tucana VI' 2-max Seat #1 is the button
Seat 1: fightingnuns ($594.20 in chips) 
Seat 2: sp2608 ($269.10 in chips) 
fightingnuns: posts small blind $2
sp2608: posts big blind $4
*** HOLE CARDS ***
Dealt to fightingnuns [Qs Kc]
fightingnuns: raises $4 to $8
sp2608: calls $4
*** FLOP *** [9d Th 5h]
sp2608: checks 
fightingnuns: bets $12
sp2608: raises $28 to $40
fightingnuns: folds 
Uncalled bet ($28) returned to sp2608
sp2608 collected $39.50 from pot
*** SUMMARY ***
Total pot $40 | Rake $0.50 
Board [9d Th 5h]
Seat 1: fightingnuns (button) (small blind) folded on the Flop
Seat 2: sp2608 (big blind) collected ($39.50)



PokerStars Game #59850583002:  Hold'em No Limit ($2/$4 USD) - 2011/03/26 17:33:02 ET
Table 'Tucana VI' 2-max Seat #2 is the button
Seat 1: fightingnuns ($574.20 in chips) 
Seat 2: sp2608 ($288.60 in chips) 
sp2608: posts small blind $2
fightingnuns: posts big blind $4
*** HOLE CARDS ***
Dealt to fightingnuns [Kc 4s]
sp2608: folds 
Uncalled bet ($2) returned to fightingnuns
fightingnuns collected $4 from pot
fightingnuns: doesn't show hand 
*** SUMMARY ***
Total pot $4 | Rake $0 
Seat 1: fightingnuns (big blind) collected ($4)
Seat 2: sp2608 (button) (small blind) folded before Flop



PokerStars Game #59850588537:  Hold'em No Limit ($2/$4 USD) - 2011/03/26 17:33:07 ET
Table 'Tucana VI' 2-max Seat #1 is the button
Seat 1: fightingnuns ($576.20 in chips) 
Seat 2: sp2608 ($286.60 in chips) 
fightingnuns: posts small blind $2
sp2608: posts big blind $4
*** HOLE CARDS ***
Dealt to fightingnuns [7d Ts]
fightingnuns: raises $4 to $8
sp2608: raises $8 to $16
fightingnuns: calls $8
*** FLOP *** [Qs 4s 6d]
sp2608: bets $32
fightingnuns: folds 
Uncalled bet ($32) returned to sp2608
sp2608 collected $31.50 from pot
sp2608: shows [6s 6h] (three of a kind, Sixes)
*** SUMMARY ***
Total pot $32 | Rake $0.50 
Board [Qs 4s 6d]
Seat 1: fightingnuns (button) (small blind) folded on the Flop
Seat 2: sp2608 (big blind) collected ($31.50)



PokerStars Game #59850609124:  Hold'em No Limit ($2/$4 USD) - 2011/03/26 17:33:29 ET
Table 'Tucana VI' 2-max Seat #2 is the button
Seat 1: fightingnuns ($560.20 in chips) 
Seat 2: sp2608 ($302.10 in chips) 
sp2608: posts small blind $2
fightingnuns: posts big blind $4
*** HOLE CARDS ***
Dealt to fightingnuns [Ac 2s]
sp2608: raises $4 to $8
fightingnuns: folds 
Uncalled bet ($4) returned to sp2608
sp2608 collected $8 from pot
*** SUMMARY ***
Total pot $8 | Rake $0 
Seat 1: fightingnuns (big blind) folded before Flop
Seat 2: sp2608 (button) (small blind) collected ($8)



PokerStars Game #59850617174:  Hold'em No Limit ($2/$4 USD) - 2011/03/26 17:33:37 ET
Table 'Tucana VI' 2-max Seat #1 is the button
Seat 1: fightingnuns ($556.20 in chips) 
Seat 2: sp2608 ($306.10 in chips) 
fightingnuns: posts small blind $2
sp2608: posts big blind $4
*** HOLE CARDS ***
Dealt to fightingnuns [7h 4d]
fightingnuns: folds 
Uncalled bet ($2) returned to sp2608
sp2608 collected $4 from pot
*** SUMMARY ***
Total pot $4 | Rake $0 
Seat 1: fightingnuns (button) (small blind) folded before Flop
Seat 2: sp2608 (big blind) collected ($4)



PokerStars Game #59850623018:  Hold'em No Limit ($2/$4 USD) - 2011/03/26 17:33:43 ET
Table 'Tucana VI' 2-max Seat #2 is the button
Seat 1: fightingnuns ($554.20 in chips) 
Seat 2: sp2608 ($308.10 in chips) 
sp2608: posts small blind $2
fightingnuns: posts big blind $4
*** HOLE CARDS ***
Dealt to fightingnuns [2c 8d]
sp2608: calls $2
fightingnuns: checks 
*** FLOP *** [Jc 3d Ah]
fightingnuns: checks 
sp2608: bets $12
fightingnuns: folds 
Uncalled bet ($12) returned to sp2608
sp2608 collected $7.60 from pot
*** SUMMARY ***
Total pot $8 | Rake $0.40 
Board [Jc 3d Ah]
Seat 1: fightingnuns (big blind) folded on the Flop
Seat 2: sp2608 (button) (small blind) collected ($7.60)



PokerStars Game #59850639078:  Hold'em No Limit ($2/$4 USD) - 2011/03/26 17:34:00 ET
Table 'Tucana VI' 2-max Seat #1 is the button
Seat 1: fightingnuns ($550.20 in chips) 
Seat 2: sp2608 ($311.70 in chips) 
fightingnuns: posts small blind $2
sp2608: posts big blind $4
*** HOLE CARDS ***
Dealt to fightingnuns [Jh 6h]
fightingnuns: raises $4 to $8
sp2608: calls $4
*** FLOP *** [9c Js Jc]
sp2608: checks 
fightingnuns: checks 
*** TURN *** [9c Js Jc] [4c]
sp2608: bets $16
fightingnuns: calls $16
*** RIVER *** [9c Js Jc 4c] [7d]
sp2608: bets $28
fightingnuns: raises $68 to $96
sp2608: calls $68
*** SHOW DOWN ***
fightingnuns: shows [Jh 6h] (three of a kind, Jacks)
sp2608: shows [Jd 3d] (three of a kind, Jacks)
sp2608 collected $119.75 from pot
fightingnuns collected $119.75 from pot
*** SUMMARY ***
Total pot $240 | Rake $0.50 
Board [9c Js Jc 4c 7d]
Seat 1: fightingnuns (button) (small blind) showed [Jh 6h] and won ($119.75) with three of a kind, Jacks
Seat 2: sp2608 (big blind) showed [Jd 3d] and won ($119.75) with three of a kind, Jacks



PokerStars Game #59850672804:  Hold'em No Limit ($2/$4 USD) - 2011/03/26 17:34:36 ET
Table 'Tucana VI' 2-max Seat #2 is the button
Seat 1: fightingnuns ($549.95 in chips) 
Seat 2: sp2608 ($311.45 in chips) 
sp2608: posts small blind $2
fightingnuns: posts big blind $4
*** HOLE CARDS ***
Dealt to fightingnuns [Jc 9h]
sp2608: calls $2
fightingnuns: checks 
*** FLOP *** [4h 4c 3s]
fightingnuns: checks 
sp2608: checks 
*** TURN *** [4h 4c 3s] [2d]
fightingnuns: checks 
sp2608: checks 
*** RIVER *** [4h 4c 3s 2d] [5s]
fightingnuns: checks 
sp2608: checks 
*** SHOW DOWN ***
fightingnuns: shows [Jc 9h] (a pair of Fours)
sp2608: shows [4d Ah] (a straight, Ace to Five)
sp2608 collected $7.60 from pot
*** SUMMARY ***
Total pot $8 | Rake $0.40 
Board [4h 4c 3s 2d 5s]
Seat 1: fightingnuns (big blind) showed [Jc 9h] and lost with a pair of Fours
Seat 2: sp2608 (button) (small blind) showed [4d Ah] and won ($7.60) with a straight, Ace to Five



PokerStars Game #59850694563:  Hold'em No Limit ($2/$4 USD) - 2011/03/26 17:34:58 ET
Table 'Tucana VI' 2-max Seat #1 is the button
Seat 1: fightingnuns ($545.95 in chips) 
Seat 2: sp2608 ($315.05 in chips) 
fightingnuns: posts small blind $2
sp2608: posts big blind $4
*** HOLE CARDS ***
Dealt to fightingnuns [Qc 6h]
fightingnuns: raises $4 to $8
sp2608: calls $4
*** FLOP *** [Qs Ah 4d]
sp2608: checks 
fightingnuns: checks 
*** TURN *** [Qs Ah 4d] [3c]
sp2608: checks 
fightingnuns: checks 
*** RIVER *** [Qs Ah 4d 3c] [Jd]
sp2608: checks 
fightingnuns: bets $8
sp2608: folds 
Uncalled bet ($8) returned to fightingnuns
fightingnuns collected $15.50 from pot
fightingnuns: doesn't show hand 
*** SUMMARY ***
Total pot $16 | Rake $0.50 
Board [Qs Ah 4d 3c Jd]
Seat 1: fightingnuns (button) (small blind) collected ($15.50)
Seat 2: sp2608 (big blind) folded on the River



PokerStars Game #59850724823:  Hold'em No Limit ($2/$4 USD) - 2011/03/26 17:35:30 ET
Table 'Tucana VI' 2-max Seat #2 is the button
Seat 1: fightingnuns ($553.45 in chips) 
Seat 2: sp2608 ($307.05 in chips) 
sp2608: posts small blind $2
fightingnuns: posts big blind $4
*** HOLE CARDS ***
Dealt to fightingnuns [7h 9h]
sp2608: calls $2
fightingnuns: raises $12 to $16
sp2608: calls $12
*** FLOP *** [Jc As 9d]
fightingnuns: bets $20
sp2608: calls $20
*** TURN *** [Jc As 9d] [Th]
fightingnuns: checks 
sp2608: checks 
*** RIVER *** [Jc As 9d Th] [7d]
fightingnuns: bets $36
sp2608: calls $36
*** SHOW DOWN ***
fightingnuns: shows [7h 9h] (two pair, Nines and Sevens)
sp2608: mucks hand 
fightingnuns collected $143.50 from pot
*** SUMMARY ***
Total pot $144 | Rake $0.50 
Board [Jc As 9d Th 7d]
Seat 1: fightingnuns (big blind) showed [7h 9h] and won ($143.50) with two pair, Nines and Sevens
Seat 2: sp2608 (button) (small blind) mucked [Ah 5h]



PokerStars Game #59850762498:  Hold'em No Limit ($2/$4 USD) - 2011/03/26 17:36:10 ET
Table 'Tucana VI' 2-max Seat #1 is the button
Seat 1: fightingnuns ($624.95 in chips) 
Seat 2: sp2608 ($235.05 in chips) 
fightingnuns: posts small blind $2
sp2608: posts big blind $4
*** HOLE CARDS ***
Dealt to fightingnuns [6c 3h]
fightingnuns: folds 
Uncalled bet ($2) returned to sp2608
sp2608 collected $4 from pot
*** SUMMARY ***
Total pot $4 | Rake $0 
Seat 1: fightingnuns (button) (small blind) folded before Flop
Seat 2: sp2608 (big blind) collected ($4)



PokerStars Game #59850768729:  Hold'em No Limit ($2/$4 USD) - 2011/03/26 17:36:17 ET
Table 'Tucana VI' 2-max Seat #2 is the button
Seat 1: fightingnuns ($622.95 in chips) 
Seat 2: sp2608 ($237.05 in chips) 
sp2608: posts small blind $2
fightingnuns: posts big blind $4
*** HOLE CARDS ***
Dealt to fightingnuns [4s 2h]
sp2608: calls $2
fightingnuns: checks 
*** FLOP *** [6h 3s Kc]
fightingnuns: checks 
sp2608: checks 
*** TURN *** [6h 3s Kc] [Ac]
fightingnuns: bets $8
sp2608: calls $8
*** RIVER *** [6h 3s Kc Ac] [Tc]
fightingnuns: checks 
sp2608: checks 
*** SHOW DOWN ***
fightingnuns: shows [4s 2h] (high card Ace)
sp2608: shows [4c 6c] (a flush, Ace high)
sp2608 collected $23.50 from pot
*** SUMMARY ***
Total pot $24 | Rake $0.50 
Board [6h 3s Kc Ac Tc]
Seat 1: fightingnuns (big blind) showed [4s 2h] and lost with high card Ace
Seat 2: sp2608 (button) (small blind) showed [4c 6c] and won ($23.50) with a flush, Ace high



PokerStars Game #59850793193:  Hold'em No Limit ($2/$4 USD) - 2011/03/26 17:36:42 ET
Table 'Tucana VI' 2-max Seat #1 is the button
Seat 1: fightingnuns ($610.95 in chips) 
Seat 2: sp2608 ($248.55 in chips) 
fightingnuns: posts small blind $2
sp2608: posts big blind $4
*** HOLE CARDS ***
Dealt to fightingnuns [5d Js]
fightingnuns: folds 
Uncalled bet ($2) returned to sp2608
sp2608 collected $4 from pot
*** SUMMARY ***
Total pot $4 | Rake $0 
Seat 1: fightingnuns (button) (small blind) folded before Flop
Seat 2: sp2608 (big blind) collected ($4)



PokerStars Game #59850798456:  Hold'em No Limit ($2/$4 USD) - 2011/03/26 17:36:48 ET
Table 'Tucana VI' 2-max Seat #2 is the button
Seat 1: fightingnuns ($608.95 in chips) 
Seat 2: sp2608 ($250.55 in chips) 
sp2608: posts small blind $2
fightingnuns: posts big blind $4
*** HOLE CARDS ***
Dealt to fightingnuns [4c Qd]
sp2608: raises $8 to $12
fightingnuns: folds 
Uncalled bet ($8) returned to sp2608
sp2608 collected $8 from pot
*** SUMMARY ***
Total pot $8 | Rake $0 
Seat 1: fightingnuns (big blind) folded before Flop
Seat 2: sp2608 (button) (small blind) collected ($8)



PokerStars Game #59850806762:  Hold'em No Limit ($2/$4 USD) - 2011/03/26 17:36:57 ET
Table 'Tucana VI' 2-max Seat #1 is the button
Seat 1: fightingnuns ($604.95 in chips) 
Seat 2: sp2608 ($254.55 in chips) 
fightingnuns: posts small blind $2
sp2608: posts big blind $4
*** HOLE CARDS ***
Dealt to fightingnuns [3h Jc]
fightingnuns: folds 
Uncalled bet ($2) returned to sp2608
sp2608 collected $4 from pot
*** SUMMARY ***
Total pot $4 | Rake $0 
Seat 1: fightingnuns (button) (small blind) folded before Flop
Seat 2: sp2608 (big blind) collected ($4)



PokerStars Game #59850812520:  Hold'em No Limit ($2/$4 USD) - 2011/03/26 17:37:03 ET
Table 'Tucana VI' 2-max Seat #2 is the button
Seat 1: fightingnuns ($602.95 in chips) 
Seat 2: sp2608 ($256.55 in chips) 
sp2608: posts small blind $2
fightingnuns: posts big blind $4
*** HOLE CARDS ***
Dealt to fightingnuns [Kd 8c]
sp2608: calls $2
fightingnuns: checks 
*** FLOP *** [Td 2c Jh]
fightingnuns: checks 
sp2608: bets $8
fightingnuns: folds 
Uncalled bet ($8) returned to sp2608
sp2608 collected $7.60 from pot
*** SUMMARY ***
Total pot $8 | Rake $0.40 
Board [Td 2c Jh]
Seat 1: fightingnuns (big blind) folded on the Flop
Seat 2: sp2608 (button) (small blind) collected ($7.60)



PokerStars Game #59850827591:  Hold'em No Limit ($2/$4 USD) - 2011/03/26 17:37:18 ET
Table 'Tucana VI' 2-max Seat #1 is the button
Seat 1: fightingnuns ($598.95 in chips) 
Seat 2: sp2608 ($260.15 in chips) 
fightingnuns: posts small blind $2
sp2608: posts big blind $4
*** HOLE CARDS ***
Dealt to fightingnuns [Qh Qd]
fightingnuns: raises $4 to $8
sp2608: calls $4
*** FLOP *** [9h 2c 7s]
sp2608: checks 
fightingnuns: bets $12
sp2608: raises $52 to $64
fightingnuns: calls $52
*** TURN *** [9h 2c 7s] [2s]
sp2608: bets $28
fightingnuns: raises $64 to $92
sp2608: raises $96.15 to $188.15 and is all-in
fightingnuns: calls $96.15
*** RIVER *** [9h 2c 7s 2s] [7c]
*** SHOW DOWN ***
sp2608: shows [7h 2h] (a full house, Sevens full of Deuces)
fightingnuns: shows [Qh Qd] (two pair, Queens and Sevens)
sp2608 collected $519.80 from pot
*** SUMMARY ***
Total pot $520.30 | Rake $0.50 
Board [9h 2c 7s 2s 7c]
Seat 1: fightingnuns (button) (small blind) showed [Qh Qd] and lost with two pair, Queens and Sevens
Seat 2: sp2608 (big blind) showed [7h 2h] and won ($519.80) with a full house, Sevens full of Deuces



PokerStars Game #59850878089:  Hold'em No Limit ($2/$4 USD) - 2011/03/26 17:38:12 ET
Table 'Tucana VI' 2-max Seat #2 is the button
Seat 1: fightingnuns ($338.80 in chips) 
Seat 2: sp2608 ($519.80 in chips) 
sp2608: posts small blind $2
fightingnuns: posts big blind $4
*** HOLE CARDS ***
Dealt to fightingnuns [Jd 8h]
sp2608: calls $2
fightingnuns: checks 
*** FLOP *** [3c Jh 8d]
fightingnuns: bets $8
sp2608: calls $8
*** TURN *** [3c Jh 8d] [Kh]
fightingnuns: bets $24
sp2608: calls $24
*** RIVER *** [3c Jh 8d Kh] [Js]
fightingnuns: bets $64
sp2608: calls $64
*** SHOW DOWN ***
fightingnuns: shows [Jd 8h] (a full house, Jacks full of Eights)
sp2608: mucks hand 
fightingnuns collected $199.50 from pot
*** SUMMARY ***
Total pot $200 | Rake $0.50 
Board [3c Jh 8d Kh Js]
Seat 1: fightingnuns (big blind) showed [Jd 8h] and won ($199.50) with a full house, Jacks full of Eights
Seat 2: sp2608 (button) (small blind) mucked [Ks 4d]



PokerStars Game #59850920552:  Hold'em No Limit ($2/$4 USD) - 2011/03/26 17:38:57 ET
Table 'Tucana VI' 2-max Seat #1 is the button
Seat 1: fightingnuns ($438.30 in chips) 
Seat 2: sp2608 ($419.80 in chips) 
fightingnuns: posts small blind $2
sp2608: posts big blind $4
*** HOLE CARDS ***
Dealt to fightingnuns [6d 9h]
fightingnuns: raises $4 to $8
sp2608: calls $4
*** FLOP *** [6c 3h 8h]
sp2608: bets $12
fightingnuns: calls $12
*** TURN *** [6c 3h 8h] [Kc]
sp2608: bets $32
fightingnuns: calls $32
*** RIVER *** [6c 3h 8h Kc] [2h]
sp2608: checks 
fightingnuns: checks 
*** SHOW DOWN ***
sp2608: shows [6s Kd] (two pair, Kings and Sixes)
fightingnuns: mucks hand 
sp2608 collected $103.50 from pot
*** SUMMARY ***
Total pot $104 | Rake $0.50 
Board [6c 3h 8h Kc 2h]
Seat 1: fightingnuns (button) (small blind) mucked [6d 9h]
Seat 2: sp2608 (big blind) showed [6s Kd] and won ($103.50) with two pair, Kings and Sixes



PokerStars Game #59850951192:  Hold'em No Limit ($2/$4 USD) - 2011/03/26 17:39:29 ET
Table 'Tucana VI' 2-max Seat #2 is the button
Seat 1: fightingnuns ($386.30 in chips) 
Seat 2: sp2608 ($471.30 in chips) 
sp2608: posts small blind $2
fightingnuns: posts big blind $4
*** HOLE CARDS ***
Dealt to fightingnuns [5s Th]
sp2608: calls $2
fightingnuns: checks 
*** FLOP *** [Kd 5h 2s]
fightingnuns: checks 
sp2608: checks 
*** TURN *** [Kd 5h 2s] [6h]
fightingnuns: checks 
sp2608: bets $12
fightingnuns: calls $12
*** RIVER *** [Kd 5h 2s 6h] [As]
fightingnuns: checks 
sp2608: checks 
*** SHOW DOWN ***
fightingnuns: shows [5s Th] (a pair of Fives)
sp2608: shows [6d 8d] (a pair of Sixes)
sp2608 collected $31.50 from pot
*** SUMMARY ***
Total pot $32 | Rake $0.50 
Board [Kd 5h 2s 6h As]
Seat 1: fightingnuns (big blind) showed [5s Th] and lost with a pair of Fives
Seat 2: sp2608 (button) (small blind) showed [6d 8d] and won ($31.50) with a pair of Sixes



PokerStars Game #59850978141:  Hold'em No Limit ($2/$4 USD) - 2011/03/26 17:39:58 ET
Table 'Tucana VI' 2-max Seat #1 is the button
Seat 1: fightingnuns ($370.30 in chips) 
Seat 2: sp2608 ($486.80 in chips) 
fightingnuns: posts small blind $2
sp2608: posts big blind $4
*** HOLE CARDS ***
Dealt to fightingnuns [Tc 5s]
fightingnuns: folds 
Uncalled bet ($2) returned to sp2608
sp2608 collected $4 from pot
*** SUMMARY ***
Total pot $4 | Rake $0 
Seat 1: fightingnuns (button) (small blind) folded before Flop
Seat 2: sp2608 (big blind) collected ($4)



PokerStars Game #59850983472:  Hold'em No Limit ($2/$4 USD) - 2011/03/26 17:40:04 ET
Table 'Tucana VI' 2-max Seat #2 is the button
Seat 1: fightingnuns ($368.30 in chips) 
Seat 2: sp2608 ($488.80 in chips) 
sp2608: posts small blind $2
fightingnuns: posts big blind $4
*** HOLE CARDS ***
Dealt to fightingnuns [8c Jh]
sp2608: calls $2
fightingnuns: checks 
*** FLOP *** [2s 3h Ah]
fightingnuns: checks 
sp2608: checks 
*** TURN *** [2s 3h Ah] [Tc]
fightingnuns: checks 
sp2608: checks 
*** RIVER *** [2s 3h Ah Tc] [7h]
fightingnuns: checks 
sp2608: checks 
*** SHOW DOWN ***
fightingnuns: shows [8c Jh] (high card Ace)
sp2608: mucks hand 
fightingnuns collected $7.60 from pot
*** SUMMARY ***
Total pot $8 | Rake $0.40 
Board [2s 3h Ah Tc 7h]
Seat 1: fightingnuns (big blind) showed [8c Jh] and won ($7.60) with high card Ace
Seat 2: sp2608 (button) (small blind) mucked [4d 8d]



PokerStars Game #59851003911:  Hold'em No Limit ($2/$4 USD) - 2011/03/26 17:40:26 ET
Table 'Tucana VI' 2-max Seat #1 is the button
Seat 1: fightingnuns ($371.90 in chips) 
Seat 2: sp2608 ($484.80 in chips) 
fightingnuns: posts small blind $2
sp2608: posts big blind $4
*** HOLE CARDS ***
Dealt to fightingnuns [9s Js]
fightingnuns: raises $8 to $12
sp2608: calls $8
*** FLOP *** [6s 3h Kc]
sp2608: checks 
fightingnuns: bets $16
sp2608: folds 
Uncalled bet ($16) returned to fightingnuns
fightingnuns collected $23.50 from pot
fightingnuns: doesn't show hand 
*** SUMMARY ***
Total pot $24 | Rake $0.50 
Board [6s 3h Kc]
Seat 1: fightingnuns (button) (small blind) collected ($23.50)
Seat 2: sp2608 (big blind) folded on the Flop



PokerStars Game #59851023511:  Hold'em No Limit ($2/$4 USD) - 2011/03/26 17:40:46 ET
Table 'Tucana VI' 2-max Seat #2 is the button
Seat 1: fightingnuns ($383.40 in chips) 
Seat 2: sp2608 ($472.80 in chips) 
sp2608: posts small blind $2
fightingnuns: posts big blind $4
*** HOLE CARDS ***
Dealt to fightingnuns [Ks 9s]
sp2608: calls $2
fightingnuns: raises $12 to $16
sp2608: calls $12
*** FLOP *** [6d 4c 7h]
fightingnuns: bets $20
sp2608: folds 
Uncalled bet ($20) returned to fightingnuns
fightingnuns collected $31.50 from pot
fightingnuns: doesn't show hand 
*** SUMMARY ***
Total pot $32 | Rake $0.50 
Board [6d 4c 7h]
Seat 1: fightingnuns (big blind) collected ($31.50)
Seat 2: sp2608 (button) (small blind) folded on the Flop



PokerStars Game #59851048797:  Hold'em No Limit ($2/$4 USD) - 2011/03/26 17:41:13 ET
Table 'Tucana VI' 2-max Seat #1 is the button
Seat 1: fightingnuns ($398.90 in chips) 
Seat 2: sp2608 ($456.80 in chips) 
fightingnuns: posts small blind $2
sp2608: posts big blind $4
*** HOLE CARDS ***
Dealt to fightingnuns [3d 5h]
fightingnuns: folds 
Uncalled bet ($2) returned to sp2608
sp2608 collected $4 from pot
*** SUMMARY ***
Total pot $4 | Rake $0 
Seat 1: fightingnuns (button) (small blind) folded before Flop
Seat 2: sp2608 (big blind) collected ($4)



PokerStars Game #59851055308:  Hold'em No Limit ($2/$4 USD) - 2011/03/26 17:41:20 ET
Table 'Tucana VI' 2-max Seat #2 is the button
Seat 1: fightingnuns ($396.90 in chips) 
Seat 2: sp2608 ($458.80 in chips) 
sp2608: posts small blind $2
fightingnuns: posts big blind $4
*** HOLE CARDS ***
Dealt to fightingnuns [Qc Td]
sp2608: raises $4 to $8
fightingnuns: calls $4
*** FLOP *** [Jd 3c Jh]
fightingnuns: checks 
sp2608: checks 
*** TURN *** [Jd 3c Jh] [7s]
fightingnuns: checks 
sp2608: checks 
*** RIVER *** [Jd 3c Jh 7s] [As]
fightingnuns: checks 
sp2608: checks 
*** SHOW DOWN ***
fightingnuns: shows [Qc Td] (a pair of Jacks)
sp2608: mucks hand 
fightingnuns collected $15.50 from pot
*** SUMMARY ***
Total pot $16 | Rake $0.50 
Board [Jd 3c Jh 7s As]
Seat 1: fightingnuns (big blind) showed [Qc Td] and won ($15.50) with a pair of Jacks
Seat 2: sp2608 (button) (small blind) mucked [Ts 9h]



PokerStars Game #59851077399:  Hold'em No Limit ($2/$4 USD) - 2011/03/26 17:41:44 ET
Table 'Tucana VI' 2-max Seat #1 is the button
Seat 1: fightingnuns ($404.40 in chips) 
Seat 2: sp2608 ($450.80 in chips) 
fightingnuns: posts small blind $2
sp2608: posts big blind $4
*** HOLE CARDS ***
Dealt to fightingnuns [5s 7d]
fightingnuns: raises $8 to $12
sp2608: calls $8
*** FLOP *** [2h 6c Kc]
sp2608: bets $24
fightingnuns: folds 
Uncalled bet ($24) returned to sp2608
sp2608 collected $23.50 from pot
*** SUMMARY ***
Total pot $24 | Rake $0.50 
Board [2h 6c Kc]
Seat 1: fightingnuns (button) (small blind) folded on the Flop
Seat 2: sp2608 (big blind) collected ($23.50)



PokerStars Game #59851095992:  Hold'em No Limit ($2/$4 USD) - 2011/03/26 17:42:04 ET
Table 'Tucana VI' 2-max Seat #2 is the button
Seat 1: fightingnuns ($392.40 in chips) 
Seat 2: sp2608 ($462.30 in chips) 
sp2608: posts small blind $2
fightingnuns: posts big blind $4
*** HOLE CARDS ***
Dealt to fightingnuns [8h 4h]
sp2608: calls $2
fightingnuns: checks 
*** FLOP *** [Ac 5c Qd]
fightingnuns: checks 
sp2608: checks 
*** TURN *** [Ac 5c Qd] [2h]
fightingnuns: checks 
sp2608: bets $8
fightingnuns: folds 
Uncalled bet ($8) returned to sp2608
sp2608 collected $7.60 from pot
*** SUMMARY ***
Total pot $8 | Rake $0.40 
Board [Ac 5c Qd 2h]
Seat 1: fightingnuns (big blind) folded on the Turn
Seat 2: sp2608 (button) (small blind) collected ($7.60)



PokerStars Game #59851117338:  Hold'em No Limit ($2/$4 USD) - 2011/03/26 17:42:27 ET
Table 'Tucana VI' 2-max Seat #1 is the button
Seat 1: fightingnuns ($388.40 in chips) 
Seat 2: sp2608 ($465.90 in chips) 
fightingnuns: posts small blind $2
sp2608: posts big blind $4
*** HOLE CARDS ***
Dealt to fightingnuns [Qc Ah]
fightingnuns: raises $8 to $12
sp2608: folds 
Uncalled bet ($8) returned to fightingnuns
fightingnuns collected $8 from pot
fightingnuns: doesn't show hand 
*** SUMMARY ***
Total pot $8 | Rake $0 
Seat 1: fightingnuns (button) (small blind) collected ($8)
Seat 2: sp2608 (big blind) folded before Flop



PokerStars Game #59851128541:  Hold'em No Limit ($2/$4 USD) - 2011/03/26 17:42:38 ET
Table 'Tucana VI' 2-max Seat #2 is the button
Seat 1: fightingnuns ($392.40 in chips) 
Seat 2: sp2608 ($461.90 in chips) 
sp2608: posts small blind $2
fightingnuns: posts big blind $4
*** HOLE CARDS ***
Dealt to fightingnuns [7c 7s]
sp2608: calls $2
fightingnuns: raises $12 to $16
sp2608: calls $12
*** FLOP *** [4d 6h As]
fightingnuns: bets $20
sp2608: calls $20
*** TURN *** [4d 6h As] [Th]
fightingnuns: checks 
sp2608: checks 
*** RIVER *** [4d 6h As Th] [5s]
fightingnuns: checks 
sp2608: checks 
*** SHOW DOWN ***
fightingnuns: shows [7c 7s] (a pair of Sevens)
sp2608: mucks hand 
fightingnuns collected $71.50 from pot
*** SUMMARY ***
Total pot $72 | Rake $0.50 
Board [4d 6h As Th 5s]
Seat 1: fightingnuns (big blind) showed [7c 7s] and won ($71.50) with a pair of Sevens
Seat 2: sp2608 (button) (small blind) mucked [Qd 4s]



PokerStars Game #59851172081:  Hold'em No Limit ($2/$4 USD) - 2011/03/26 17:43:25 ET
Table 'Tucana VI' 2-max Seat #1 is the button
Seat 1: fightingnuns ($427.90 in chips) 
Seat 2: sp2608 ($425.90 in chips) 
fightingnuns: posts small blind $2
sp2608: posts big blind $4
*** HOLE CARDS ***
Dealt to fightingnuns [3h 3s]
fightingnuns: raises $8 to $12
sp2608: calls $8
*** FLOP *** [Jc 7c Ks]
sp2608: checks 
fightingnuns: checks 
*** TURN *** [Jc 7c Ks] [2h]
sp2608: bets $8
fightingnuns: folds 
Uncalled bet ($8) returned to sp2608
sp2608 collected $23.50 from pot
*** SUMMARY ***
Total pot $24 | Rake $0.50 
Board [Jc 7c Ks 2h]
Seat 1: fightingnuns (button) (small blind) folded on the Turn
Seat 2: sp2608 (big blind) collected ($23.50)



PokerStars Game #59851201219:  Hold'em No Limit ($2/$4 USD) - 2011/03/26 17:43:56 ET
Table 'Tucana VI' 2-max Seat #2 is the button
Seat 1: fightingnuns ($415.90 in chips) 
Seat 2: sp2608 ($437.40 in chips) 
sp2608: posts small blind $2
fightingnuns: posts big blind $4
*** HOLE CARDS ***
Dealt to fightingnuns [2h 6c]
sp2608: folds 
Uncalled bet ($2) returned to fightingnuns
fightingnuns collected $4 from pot
fightingnuns: doesn't show hand 
*** SUMMARY ***
Total pot $4 | Rake $0 
Seat 1: fightingnuns (big blind) collected ($4)
Seat 2: sp2608 (button) (small blind) folded before Flop



PokerStars Game #59851206962:  Hold'em No Limit ($2/$4 USD) - 2011/03/26 17:44:02 ET
Table 'Tucana VI' 2-max Seat #1 is the button
Seat 1: fightingnuns ($417.90 in chips) 
Seat 2: sp2608 ($435.40 in chips) 
fightingnuns: posts small blind $2
sp2608: posts big blind $4
*** HOLE CARDS ***
Dealt to fightingnuns [Kc 3d]
fightingnuns: raises $8 to $12
sp2608: calls $8
*** FLOP *** [Th 8c 6h]
sp2608: bets $44
fightingnuns: folds 
Uncalled bet ($44) returned to sp2608
sp2608 collected $23.50 from pot
*** SUMMARY ***
Total pot $24 | Rake $0.50 
Board [Th 8c 6h]
Seat 1: fightingnuns (button) (small blind) folded on the Flop
Seat 2: sp2608 (big blind) collected ($23.50)



PokerStars Game #59851222284:  Hold'em No Limit ($2/$4 USD) - 2011/03/26 17:44:19 ET
Table 'Tucana VI' 2-max Seat #2 is the button
Seat 1: fightingnuns ($405.90 in chips) 
Seat 2: sp2608 ($446.90 in chips) 
sp2608: posts small blind $2
fightingnuns: posts big blind $4
*** HOLE CARDS ***
Dealt to fightingnuns [8h 6s]
sp2608: folds 
Uncalled bet ($2) returned to fightingnuns
fightingnuns collected $4 from pot
fightingnuns: doesn't show hand 
*** SUMMARY ***
Total pot $4 | Rake $0 
Seat 1: fightingnuns (big blind) collected ($4)
Seat 2: sp2608 (button) (small blind) folded before Flop



PokerStars Game #59851228057:  Hold'em No Limit ($2/$4 USD) - 2011/03/26 17:44:25 ET
Table 'Tucana VI' 2-max Seat #1 is the button
Seat 1: fightingnuns ($407.90 in chips) 
Seat 2: sp2608 ($444.90 in chips) 
fightingnuns: posts small blind $2
sp2608: posts big blind $4
*** HOLE CARDS ***
Dealt to fightingnuns [4c 7s]
fightingnuns: folds 
Uncalled bet ($2) returned to sp2608
sp2608 collected $4 from pot
*** SUMMARY ***
Total pot $4 | Rake $0 
Seat 1: fightingnuns (button) (small blind) folded before Flop
Seat 2: sp2608 (big blind) collected ($4)



PokerStars Game #59851233247:  Hold'em No Limit ($2/$4 USD) - 2011/03/26 17:44:31 ET
Table 'Tucana VI' 2-max Seat #2 is the button
Seat 1: fightingnuns ($405.90 in chips) 
Seat 2: sp2608 ($446.90 in chips) 
sp2608: posts small blind $2
fightingnuns: posts big blind $4
*** HOLE CARDS ***
Dealt to fightingnuns [8s 6c]
sp2608: calls $2
fightingnuns: checks 
*** FLOP *** [4h As Ah]
fightingnuns: bets $8
sp2608: folds 
Uncalled bet ($8) returned to fightingnuns
fightingnuns collected $7.60 from pot
fightingnuns: doesn't show hand 
*** SUMMARY ***
Total pot $8 | Rake $0.40 
Board [4h As Ah]
Seat 1: fightingnuns (big blind) collected ($7.60)
Seat 2: sp2608 (button) (small blind) folded on the Flop



PokerStars Game #59851246101:  Hold'em No Limit ($2/$4 USD) - 2011/03/26 17:44:44 ET
Table 'Tucana VI' 2-max Seat #1 is the button
Seat 1: fightingnuns ($409.50 in chips) 
Seat 2: sp2608 ($442.90 in chips) 
fightingnuns: posts small blind $2
sp2608: posts big blind $4
*** HOLE CARDS ***
Dealt to fightingnuns [Tc 3d]
fightingnuns: folds 
Uncalled bet ($2) returned to sp2608
sp2608 collected $4 from pot
*** SUMMARY ***
Total pot $4 | Rake $0 
Seat 1: fightingnuns (button) (small blind) folded before Flop
Seat 2: sp2608 (big blind) collected ($4)



PokerStars Game #59851251225:  Hold'em No Limit ($2/$4 USD) - 2011/03/26 17:44:50 ET
Table 'Tucana VI' 2-max Seat #2 is the button
Seat 1: fightingnuns ($407.50 in chips) 
Seat 2: sp2608 ($444.90 in chips) 
sp2608: posts small blind $2
fightingnuns: posts big blind $4
*** HOLE CARDS ***
Dealt to fightingnuns [4s 2c]
sp2608: calls $2
fightingnuns: checks 
*** FLOP *** [Qh 6s 2h]
fightingnuns: checks 
sp2608: bets $16
fightingnuns: folds 
Uncalled bet ($16) returned to sp2608
sp2608 collected $7.60 from pot
*** SUMMARY ***
Total pot $8 | Rake $0.40 
Board [Qh 6s 2h]
Seat 1: fightingnuns (big blind) folded on the Flop
Seat 2: sp2608 (button) (small blind) collected ($7.60)



PokerStars Game #59851265768:  Hold'em No Limit ($2/$4 USD) - 2011/03/26 17:45:05 ET
Table 'Tucana VI' 2-max Seat #1 is the button
Seat 1: fightingnuns ($403.50 in chips) 
Seat 2: sp2608 ($448.50 in chips) 
fightingnuns: posts small blind $2
sp2608: posts big blind $4
*** HOLE CARDS ***
Dealt to fightingnuns [3c Th]
fightingnuns: folds 
Uncalled bet ($2) returned to sp2608
sp2608 collected $4 from pot
*** SUMMARY ***
Total pot $4 | Rake $0 
Seat 1: fightingnuns (button) (small blind) folded before Flop
Seat 2: sp2608 (big blind) collected ($4)



PokerStars Game #59851270852:  Hold'em No Limit ($2/$4 USD) - 2011/03/26 17:45:11 ET
Table 'Tucana VI' 2-max Seat #2 is the button
Seat 1: fightingnuns ($401.50 in chips) 
Seat 2: sp2608 ($450.50 in chips) 
sp2608: posts small blind $2
fightingnuns: posts big blind $4
*** HOLE CARDS ***
Dealt to fightingnuns [Ah 8s]
sp2608: calls $2
fightingnuns: raises $12 to $16
sp2608: calls $12
*** FLOP *** [7h 2h Jd]
fightingnuns: bets $20
sp2608: folds 
Uncalled bet ($20) returned to fightingnuns
fightingnuns collected $31.50 from pot
fightingnuns: doesn't show hand 
*** SUMMARY ***
Total pot $32 | Rake $0.50 
Board [7h 2h Jd]
Seat 1: fightingnuns (big blind) collected ($31.50)
Seat 2: sp2608 (button) (small blind) folded on the Flop



PokerStars Game #59851290761:  Hold'em No Limit ($2/$4 USD) - 2011/03/26 17:45:32 ET
Table 'Tucana VI' 2-max Seat #1 is the button
Seat 1: fightingnuns ($417 in chips) 
Seat 2: sp2608 ($434.50 in chips) 
fightingnuns: posts small blind $2
sp2608: posts big blind $4
*** HOLE CARDS ***
Dealt to fightingnuns [4c 6h]
fightingnuns: folds 
Uncalled bet ($2) returned to sp2608
sp2608 collected $4 from pot
*** SUMMARY ***
Total pot $4 | Rake $0 
Seat 1: fightingnuns (button) (small blind) folded before Flop
Seat 2: sp2608 (big blind) collected ($4)



PokerStars Game #59851296881:  Hold'em No Limit ($2/$4 USD) - 2011/03/26 17:45:38 ET
Table 'Tucana VI' 2-max Seat #2 is the button
Seat 1: fightingnuns ($415 in chips) 
Seat 2: sp2608 ($436.50 in chips) 
sp2608: posts small blind $2
fightingnuns: posts big blind $4
*** HOLE CARDS ***
Dealt to fightingnuns [2h As]
sp2608: calls $2
fightingnuns: checks 
*** FLOP *** [7d 9h Tc]
fightingnuns: checks 
sp2608: checks 
*** TURN *** [7d 9h Tc] [Ts]
fightingnuns: checks 
sp2608: checks 
*** RIVER *** [7d 9h Tc Ts] [6s]
fightingnuns: checks 
sp2608: bets $8
fightingnuns: folds 
Uncalled bet ($8) returned to sp2608
sp2608 collected $7.60 from pot
*** SUMMARY ***
Total pot $8 | Rake $0.40 
Board [7d 9h Tc Ts 6s]
Seat 1: fightingnuns (big blind) folded on the River
Seat 2: sp2608 (button) (small blind) collected ($7.60)



PokerStars Game #59851320387:  Hold'em No Limit ($2/$4 USD) - 2011/03/26 17:46:04 ET
Table 'Tucana VI' 2-max Seat #1 is the button
Seat 1: fightingnuns ($411 in chips) 
Seat 2: sp2608 ($440.10 in chips) 
fightingnuns: posts small blind $2
sp2608: posts big blind $4
*** HOLE CARDS ***
Dealt to fightingnuns [Qs 9h]
fightingnuns: raises $8 to $12
sp2608: calls $8
*** FLOP *** [Ad 6h 9s]
sp2608: bets $24
fightingnuns: calls $24
*** TURN *** [Ad 6h 9s] [6d]
sp2608: bets $36
fightingnuns: calls $36
*** RIVER *** [Ad 6h 9s 6d] [4h]
sp2608: checks 
fightingnuns: checks 
*** SHOW DOWN ***
sp2608: shows [5c Ac] (two pair, Aces and Sixes)
fightingnuns: mucks hand 
sp2608 collected $143.50 from pot
*** SUMMARY ***
Total pot $144 | Rake $0.50 
Board [Ad 6h 9s 6d 4h]
Seat 1: fightingnuns (button) (small blind) mucked [Qs 9h]
Seat 2: sp2608 (big blind) showed [5c Ac] and won ($143.50) with two pair, Aces and Sixes



PokerStars Game #59851350067:  Hold'em No Limit ($2/$4 USD) - 2011/03/26 17:46:35 ET
Table 'Tucana VI' 2-max Seat #2 is the button
Seat 1: fightingnuns ($339 in chips) 
Seat 2: sp2608 ($511.60 in chips) 
sp2608: posts small blind $2
fightingnuns: posts big blind $4
*** HOLE CARDS ***
Dealt to fightingnuns [Qd 7s]
sp2608: raises $8 to $12
fightingnuns: folds 
Uncalled bet ($8) returned to sp2608
sp2608 collected $8 from pot
*** SUMMARY ***
Total pot $8 | Rake $0 
Seat 1: fightingnuns (big blind) folded before Flop
Seat 2: sp2608 (button) (small blind) collected ($8)



PokerStars Game #59851358837:  Hold'em No Limit ($2/$4 USD) - 2011/03/26 17:46:45 ET
Table 'Tucana VI' 2-max Seat #1 is the button
Seat 1: fightingnuns ($335 in chips) 
Seat 2: sp2608 ($515.60 in chips) 
fightingnuns: posts small blind $2
sp2608: posts big blind $4
*** HOLE CARDS ***
Dealt to fightingnuns [Jd Kh]
fightingnuns: raises $8 to $12
sp2608: folds 
Uncalled bet ($8) returned to fightingnuns
fightingnuns collected $8 from pot
fightingnuns: doesn't show hand 
*** SUMMARY ***
Total pot $8 | Rake $0 
Seat 1: fightingnuns (button) (small blind) collected ($8)
Seat 2: sp2608 (big blind) folded before Flop



PokerStars Game #59851366750:  Hold'em No Limit ($2/$4 USD) - 2011/03/26 17:46:53 ET
Table 'Tucana VI' 2-max Seat #2 is the button
Seat 1: fightingnuns ($339 in chips) 
Seat 2: sp2608 ($511.60 in chips) 
sp2608: posts small blind $2
fightingnuns: posts big blind $4
*** HOLE CARDS ***
Dealt to fightingnuns [7s 5s]
sp2608: calls $2
fightingnuns: checks 
*** FLOP *** [Jh 5c 6h]
fightingnuns: checks 
sp2608: bets $12
fightingnuns: folds 
Uncalled bet ($12) returned to sp2608
sp2608 collected $7.60 from pot
*** SUMMARY ***
Total pot $8 | Rake $0.40 
Board [Jh 5c 6h]
Seat 1: fightingnuns (big blind) folded on the Flop
Seat 2: sp2608 (button) (small blind) collected ($7.60)



PokerStars Game #59851380875:  Hold'em No Limit ($2/$4 USD) - 2011/03/26 17:47:08 ET
Table 'Tucana VI' 2-max Seat #1 is the button
Seat 1: fightingnuns ($335 in chips) 
Seat 2: sp2608 ($515.20 in chips) 
fightingnuns: posts small blind $2
sp2608: posts big blind $4
*** HOLE CARDS ***
Dealt to fightingnuns [Jh 5h]
fightingnuns: raises $8 to $12
sp2608: calls $8
*** FLOP *** [As Ac Th]
sp2608: checks 
fightingnuns: bets $16
sp2608: folds 
Uncalled bet ($16) returned to fightingnuns
fightingnuns collected $23.50 from pot
fightingnuns: doesn't show hand 
*** SUMMARY ***
Total pot $24 | Rake $0.50 
Board [As Ac Th]
Seat 1: fightingnuns (button) (small blind) collected ($23.50)
Seat 2: sp2608 (big blind) folded on the Flop



PokerStars Game #59851398804:  Hold'em No Limit ($2/$4 USD) - 2011/03/26 17:47:27 ET
Table 'Tucana VI' 2-max Seat #2 is the button
Seat 1: fightingnuns ($346.50 in chips) 
Seat 2: sp2608 ($503.20 in chips) 
sp2608: posts small blind $2
fightingnuns: posts big blind $4
*** HOLE CARDS ***
Dealt to fightingnuns [3h 5d]
sp2608: calls $2
fightingnuns: checks 
*** FLOP *** [Kc 6h 9h]
fightingnuns: checks 
sp2608: checks 
*** TURN *** [Kc 6h 9h] [5c]
fightingnuns: checks 
sp2608: checks 
*** RIVER *** [Kc 6h 9h 5c] [6d]
fightingnuns: bets $8
sp2608: folds 
Uncalled bet ($8) returned to fightingnuns
fightingnuns collected $7.60 from pot
fightingnuns: doesn't show hand 
*** SUMMARY ***
Total pot $8 | Rake $0.40 
Board [Kc 6h 9h 5c 6d]
Seat 1: fightingnuns (big blind) collected ($7.60)
Seat 2: sp2608 (button) (small blind) folded on the River



PokerStars Game #59851420222:  Hold'em No Limit ($2/$4 USD) - 2011/03/26 17:47:50 ET
Table 'Tucana VI' 2-max Seat #1 is the button
Seat 1: fightingnuns ($350.10 in chips) 
Seat 2: sp2608 ($499.20 in chips) 
fightingnuns: posts small blind $2
sp2608: posts big blind $4
*** HOLE CARDS ***
Dealt to fightingnuns [8s 4h]
fightingnuns: folds 
Uncalled bet ($2) returned to sp2608
sp2608 collected $4 from pot
*** SUMMARY ***
Total pot $4 | Rake $0 
Seat 1: fightingnuns (button) (small blind) folded before Flop
Seat 2: sp2608 (big blind) collected ($4)



PokerStars Game #59851426476:  Hold'em No Limit ($2/$4 USD) - 2011/03/26 17:47:56 ET
Table 'Tucana VI' 2-max Seat #2 is the button
Seat 1: fightingnuns ($348.10 in chips) 
Seat 2: sp2608 ($501.20 in chips) 
sp2608: posts small blind $2
fightingnuns: posts big blind $4
*** HOLE CARDS ***
Dealt to fightingnuns [6h 3s]
sp2608: calls $2
fightingnuns: checks 
*** FLOP *** [7h 9h 4d]
fightingnuns: checks 
sp2608: bets $8
fightingnuns: folds 
Uncalled bet ($8) returned to sp2608
sp2608 collected $7.60 from pot
*** SUMMARY ***
Total pot $8 | Rake $0.40 
Board [7h 9h 4d]
Seat 1: fightingnuns (big blind) folded on the Flop
Seat 2: sp2608 (button) (small blind) collected ($7.60)



PokerStars Game #59851439560:  Hold'em No Limit ($2/$4 USD) - 2011/03/26 17:48:10 ET
Table 'Tucana VI' 2-max Seat #1 is the button
Seat 1: fightingnuns ($344.10 in chips) 
Seat 2: sp2608 ($504.80 in chips) 
fightingnuns: posts small blind $2
sp2608: posts big blind $4
*** HOLE CARDS ***
Dealt to fightingnuns [3h As]
fightingnuns: raises $8 to $12
sp2608: calls $8
*** FLOP *** [Ts Kh Qc]
sp2608: checks 
fightingnuns: checks 
*** TURN *** [Ts Kh Qc] [Kd]
sp2608: bets $20
fightingnuns: folds 
Uncalled bet ($20) returned to sp2608
sp2608 collected $23.50 from pot
*** SUMMARY ***
Total pot $24 | Rake $0.50 
Board [Ts Kh Qc Kd]
Seat 1: fightingnuns (button) (small blind) folded on the Turn
Seat 2: sp2608 (big blind) collected ($23.50)



PokerStars Game #59851460820:  Hold'em No Limit ($2/$4 USD) - 2011/03/26 17:48:33 ET
Table 'Tucana VI' 2-max Seat #2 is the button
Seat 1: fightingnuns ($332.10 in chips) 
Seat 2: sp2608 ($516.30 in chips) 
sp2608: posts small blind $2
fightingnuns: posts big blind $4
*** HOLE CARDS ***
Dealt to fightingnuns [4d 2h]
sp2608: raises $4 to $8
fightingnuns: folds 
Uncalled bet ($4) returned to sp2608
sp2608 collected $8 from pot
*** SUMMARY ***
Total pot $8 | Rake $0 
Seat 1: fightingnuns (big blind) folded before Flop
Seat 2: sp2608 (button) (small blind) collected ($8)



PokerStars Game #59851468001:  Hold'em No Limit ($2/$4 USD) - 2011/03/26 17:48:41 ET
Table 'Tucana VI' 2-max Seat #1 is the button
Seat 1: fightingnuns ($328.10 in chips) 
Seat 2: sp2608 ($520.30 in chips) 
fightingnuns: posts small blind $2
sp2608: posts big blind $4
*** HOLE CARDS ***
Dealt to fightingnuns [3c 6c]
fightingnuns: raises $8 to $12
sp2608: calls $8
*** FLOP *** [3s 9c 2d]
sp2608: bets $8
fightingnuns: calls $8
*** TURN *** [3s 9c 2d] [Ts]
sp2608: checks 
fightingnuns: checks 
*** RIVER *** [3s 9c 2d Ts] [As]
sp2608: checks 
fightingnuns: checks 
*** SHOW DOWN ***
sp2608: shows [5h Qd] (high card Ace)
fightingnuns: shows [3c 6c] (a pair of Threes)
fightingnuns collected $39.50 from pot
*** SUMMARY ***
Total pot $40 | Rake $0.50 
Board [3s 9c 2d Ts As]
Seat 1: fightingnuns (button) (small blind) showed [3c 6c] and won ($39.50) with a pair of Threes
Seat 2: sp2608 (big blind) showed [5h Qd] and lost with high card Ace



PokerStars Game #59851497922:  Hold'em No Limit ($2/$4 USD) - 2011/03/26 17:49:13 ET
Table 'Tucana VI' 2-max Seat #2 is the button
Seat 1: fightingnuns ($347.60 in chips) 
Seat 2: sp2608 ($500.30 in chips) 
sp2608: posts small blind $2
fightingnuns: posts big blind $4
*** HOLE CARDS ***
Dealt to fightingnuns [Ah 8c]
sp2608: raises $4 to $8
fightingnuns: calls $4
*** FLOP *** [8h 3d 9h]
fightingnuns: checks 
sp2608: bets $12
fightingnuns: calls $12
*** TURN *** [8h 3d 9h] [9c]
fightingnuns: checks 
sp2608: bets $40
fightingnuns: calls $40
*** RIVER *** [8h 3d 9h 9c] [2c]
fightingnuns: checks 
sp2608: bets $120
fightingnuns: calls $120
*** SHOW DOWN ***
sp2608: shows [9d Ad] (three of a kind, Nines)
fightingnuns: mucks hand 
sp2608 collected $359.50 from pot
*** SUMMARY ***
Total pot $360 | Rake $0.50 
Board [8h 3d 9h 9c 2c]
Seat 1: fightingnuns (big blind) mucked [Ah 8c]
Seat 2: sp2608 (button) (small blind) showed [9d Ad] and won ($359.50) with three of a kind, Nines



PokerStars Game #59851533141:  Hold'em No Limit ($2/$4 USD) - 2011/03/26 17:49:50 ET
Table 'Tucana VI' 2-max Seat #1 is the button
Seat 1: fightingnuns ($200 in chips) 
Seat 2: sp2608 ($679.80 in chips) 
fightingnuns: posts small blind $2
sp2608: posts big blind $4
*** HOLE CARDS ***
Dealt to fightingnuns [8c 6d]
fightingnuns: raises $8 to $12
sp2608: calls $8
*** FLOP *** [Jh Qs Qd]
sp2608: checks 
fightingnuns: bets $12
sp2608: folds 
Uncalled bet ($12) returned to fightingnuns
fightingnuns collected $23.50 from pot
fightingnuns: doesn't show hand 
*** SUMMARY ***
Total pot $24 | Rake $0.50 
Board [Jh Qs Qd]
Seat 1: fightingnuns (button) (small blind) collected ($23.50)
Seat 2: sp2608 (big blind) folded on the Flop



PokerStars Game #59851554714:  Hold'em No Limit ($2/$4 USD) - 2011/03/26 17:50:13 ET
Table 'Tucana VI' 2-max Seat #2 is the button
Seat 1: fightingnuns ($211.50 in chips) 
Seat 2: sp2608 ($667.80 in chips) 
sp2608: posts small blind $2
fightingnuns: posts big blind $4
*** HOLE CARDS ***
Dealt to fightingnuns [5c Qh]
sp2608: calls $2
fightingnuns: checks 
*** FLOP *** [4d Ah Th]
fightingnuns: checks 
sp2608: bets $8
fightingnuns: folds 
Uncalled bet ($8) returned to sp2608
sp2608 collected $7.60 from pot
*** SUMMARY ***
Total pot $8 | Rake $0.40 
Board [4d Ah Th]
Seat 1: fightingnuns (big blind) folded on the Flop
Seat 2: sp2608 (button) (small blind) collected ($7.60)



PokerStars Game #59851570120:  Hold'em No Limit ($2/$4 USD) - 2011/03/26 17:50:29 ET
Table 'Tucana VI' 2-max Seat #1 is the button
Seat 1: fightingnuns ($207.50 in chips) 
Seat 2: sp2608 ($671.40 in chips) 
fightingnuns: posts small blind $2
sp2608: posts big blind $4
*** HOLE CARDS ***
Dealt to fightingnuns [9d 2d]
fightingnuns: raises $8 to $12
sp2608: raises $12 to $24
fightingnuns: calls $12
*** FLOP *** [Js Jc 2h]
sp2608: checks 
fightingnuns: checks 
*** TURN *** [Js Jc 2h] [4d]
sp2608: bets $20
fightingnuns: calls $20
*** RIVER *** [Js Jc 2h 4d] [2s]
sp2608: checks 
fightingnuns: bets $40
sp2608: folds 
Uncalled bet ($40) returned to fightingnuns
fightingnuns collected $87.50 from pot
fightingnuns: doesn't show hand 
*** SUMMARY ***
Total pot $88 | Rake $0.50 
Board [Js Jc 2h 4d 2s]
Seat 1: fightingnuns (button) (small blind) collected ($87.50)
Seat 2: sp2608 (big blind) folded on the River



PokerStars Game #59851603990:  Hold'em No Limit ($2/$4 USD) - 2011/03/26 17:51:05 ET
Table 'Tucana VI' 2-max Seat #2 is the button
Seat 1: fightingnuns ($251 in chips) 
Seat 2: sp2608 ($627.40 in chips) 
sp2608: posts small blind $2
fightingnuns: posts big blind $4
*** HOLE CARDS ***
Dealt to fightingnuns [7d 8h]
sp2608: calls $2
fightingnuns: checks 
*** FLOP *** [9s 5c 4s]
fightingnuns: checks 
sp2608: checks 
*** TURN *** [9s 5c 4s] [4h]
fightingnuns: bets $8
sp2608: folds 
Uncalled bet ($8) returned to fightingnuns
fightingnuns collected $7.60 from pot
fightingnuns: doesn't show hand 
*** SUMMARY ***
Total pot $8 | Rake $0.40 
Board [9s 5c 4s 4h]
Seat 1: fightingnuns (big blind) collected ($7.60)
Seat 2: sp2608 (button) (small blind) folded on the Turn



PokerStars Game #59851621794:  Hold'em No Limit ($2/$4 USD) - 2011/03/26 17:51:24 ET
Table 'Tucana VI' 2-max Seat #1 is the button
Seat 1: fightingnuns ($254.60 in chips) 
Seat 2: sp2608 ($623.40 in chips) 
fightingnuns: posts small blind $2
sp2608: posts big blind $4
*** HOLE CARDS ***
Dealt to fightingnuns [Kd 5s]
fightingnuns: raises $4 to $8
sp2608: calls $4
*** FLOP *** [6d Js 9c]
sp2608: bets $12
fightingnuns: folds 
Uncalled bet ($12) returned to sp2608
sp2608 collected $15.50 from pot
*** SUMMARY ***
Total pot $16 | Rake $0.50 
Board [6d Js 9c]
Seat 1: fightingnuns (button) (small blind) folded on the Flop
Seat 2: sp2608 (big blind) collected ($15.50)



PokerStars Game #59851639675:  Hold'em No Limit ($2/$4 USD) - 2011/03/26 17:51:43 ET
Table 'Tucana VI' 2-max Seat #2 is the button
Seat 1: fightingnuns ($246.60 in chips) 
Seat 2: sp2608 ($630.90 in chips) 
sp2608: posts small blind $2
fightingnuns: posts big blind $4
*** HOLE CARDS ***
Dealt to fightingnuns [Ts 8h]
sp2608: calls $2
fightingnuns: checks 
*** FLOP *** [2h Ad 6s]
fightingnuns: checks 
sp2608: bets $12
fightingnuns: folds 
Uncalled bet ($12) returned to sp2608
sp2608 collected $7.60 from pot
*** SUMMARY ***
Total pot $8 | Rake $0.40 
Board [2h Ad 6s]
Seat 1: fightingnuns (big blind) folded on the Flop
Seat 2: sp2608 (button) (small blind) collected ($7.60)



PokerStars Game #59851653460:  Hold'em No Limit ($2/$4 USD) - 2011/03/26 17:51:58 ET
Table 'Tucana VI' 2-max Seat #1 is the button
Seat 1: fightingnuns ($242.60 in chips) 
Seat 2: sp2608 ($634.50 in chips) 
fightingnuns: posts small blind $2
sp2608: posts big blind $4
*** HOLE CARDS ***
Dealt to fightingnuns [7h Kc]
fightingnuns: raises $8 to $12
sp2608: calls $8
*** FLOP *** [5h Js Ks]
sp2608: checks 
fightingnuns: bets $16
sp2608: calls $16
*** TURN *** [5h Js Ks] [9s]
sp2608: checks 
fightingnuns: checks 
*** RIVER *** [5h Js Ks 9s] [Qh]
sp2608: bets $606.50 and is all-in
fightingnuns: folds 
Uncalled bet ($606.50) returned to sp2608
sp2608 collected $55.50 from pot
*** SUMMARY ***
Total pot $56 | Rake $0.50 
Board [5h Js Ks 9s Qh]
Seat 1: fightingnuns (button) (small blind) folded on the River
Seat 2: sp2608 (big blind) collected ($55.50)



PokerStars Game #59851721220:  Hold'em No Limit ($2/$4 USD) - 2011/03/26 17:53:11 ET
Table 'Tucana VI' 2-max Seat #2 is the button
Seat 1: fightingnuns ($214.60 in chips) 
Seat 2: sp2608 ($662 in chips) 
sp2608: posts small blind $2
fightingnuns: posts big blind $4
*** HOLE CARDS ***
Dealt to fightingnuns [Qh 8h]
sp2608: raises $4 to $8
fightingnuns: calls $4
*** FLOP *** [8c 5d Js]
fightingnuns: checks 
sp2608: checks 
*** TURN *** [8c 5d Js] [2d]
fightingnuns: bets $8
sp2608: folds 
Uncalled bet ($8) returned to fightingnuns
fightingnuns collected $15.50 from pot
fightingnuns: doesn't show hand 
*** SUMMARY ***
Total pot $16 | Rake $0.50 
Board [8c 5d Js 2d]
Seat 1: fightingnuns (big blind) collected ($15.50)
Seat 2: sp2608 (button) (small blind) folded on the Turn



PokerStars Game #59851738777:  Hold'em No Limit ($2/$4 USD) - 2011/03/26 17:53:30 ET
Table 'Tucana VI' 2-max Seat #1 is the button
Seat 1: fightingnuns ($222.10 in chips) 
Seat 2: sp2608 ($654 in chips) 
fightingnuns: posts small blind $2
sp2608: posts big blind $4
*** HOLE CARDS ***
Dealt to fightingnuns [8c Jd]
fightingnuns: raises $8 to $12
sp2608: calls $8
*** FLOP *** [8s Kd 6s]
sp2608: checks 
fightingnuns: bets $16
sp2608: folds 
Uncalled bet ($16) returned to fightingnuns
fightingnuns collected $23.50 from pot
fightingnuns: doesn't show hand 
*** SUMMARY ***
Total pot $24 | Rake $0.50 
Board [8s Kd 6s]
Seat 1: fightingnuns (button) (small blind) collected ($23.50)
Seat 2: sp2608 (big blind) folded on the Flop



PokerStars Game #59851773200:  Hold'em No Limit ($2/$4 USD) - 2011/03/26 17:54:07 ET
Table 'Tucana VI' 2-max Seat #2 is the button
Seat 1: fightingnuns ($233.60 in chips) 
Seat 2: sp2608 ($642 in chips) 
sp2608: posts small blind $2
fightingnuns: posts big blind $4
*** HOLE CARDS ***
Dealt to fightingnuns [3h Ad]
sp2608: calls $2
fightingnuns: checks 
*** FLOP *** [4s 6s 4d]
fightingnuns: checks 
sp2608: checks 
*** TURN *** [4s 6s 4d] [6d]
fightingnuns: checks 
sp2608: checks 
*** RIVER *** [4s 6s 4d 6d] [7d]
fightingnuns: checks 
sp2608: bets $8
fightingnuns: calls $8
*** SHOW DOWN ***
sp2608: shows [4h 9h] (a full house, Fours full of Sixes)
fightingnuns: mucks hand 
sp2608 collected $23.50 from pot
*** SUMMARY ***
Total pot $24 | Rake $0.50 
Board [4s 6s 4d 6d 7d]
Seat 1: fightingnuns (big blind) mucked [3h Ad]
Seat 2: sp2608 (button) (small blind) showed [4h 9h] and won ($23.50) with a full house, Fours full of Sixes



PokerStars Game #59851795065:  Hold'em No Limit ($2/$4 USD) - 2011/03/26 17:54:31 ET
Table 'Tucana VI' 2-max Seat #1 is the button
Seat 1: fightingnuns ($221.60 in chips) 
Seat 2: sp2608 ($653.50 in chips) 
fightingnuns: posts small blind $2
sp2608: posts big blind $4
*** HOLE CARDS ***
Dealt to fightingnuns [3h Kh]
fightingnuns: raises $8 to $12
sp2608: raises $20 to $32
fightingnuns: folds 
Uncalled bet ($20) returned to sp2608
sp2608 collected $24 from pot
*** SUMMARY ***
Total pot $24 | Rake $0 
Seat 1: fightingnuns (button) (small blind) folded before Flop
Seat 2: sp2608 (big blind) collected ($24)



PokerStars Game #59851806913:  Hold'em No Limit ($2/$4 USD) - 2011/03/26 17:54:43 ET
Table 'Tucana VI' 2-max Seat #2 is the button
Seat 1: fightingnuns ($209.60 in chips) 
Seat 2: sp2608 ($665.50 in chips) 
sp2608: posts small blind $2
fightingnuns: posts big blind $4
*** HOLE CARDS ***
Dealt to fightingnuns [3d 3s]
sp2608: calls $2
fightingnuns: checks 
*** FLOP *** [Qd 6h 4c]
fightingnuns: checks 
sp2608: checks 
*** TURN *** [Qd 6h 4c] [7c]
fightingnuns: checks 
sp2608: bets $12
fightingnuns: folds 
Uncalled bet ($12) returned to sp2608
sp2608 collected $7.60 from pot
*** SUMMARY ***
Total pot $8 | Rake $0.40 
Board [Qd 6h 4c 7c]
Seat 1: fightingnuns (big blind) folded on the Turn
Seat 2: sp2608 (button) (small blind) collected ($7.60)



PokerStars Game #59851824574:  Hold'em No Limit ($2/$4 USD) - 2011/03/26 17:55:03 ET
Table 'Tucana VI' 2-max Seat #1 is the button
Seat 1: fightingnuns ($205.60 in chips) 
Seat 2: sp2608 ($669.10 in chips) 
fightingnuns: posts small blind $2
sp2608: posts big blind $4
*** HOLE CARDS ***
Dealt to fightingnuns [Ah 6c]
fightingnuns: raises $8 to $12
sp2608: raises $12 to $24
fightingnuns: calls $12
*** FLOP *** [3d 4c Jh]
sp2608: bets $52
fightingnuns: folds 
Uncalled bet ($52) returned to sp2608
sp2608 collected $47.50 from pot
*** SUMMARY ***
Total pot $48 | Rake $0.50 
Board [3d 4c Jh]
Seat 1: fightingnuns (button) (small blind) folded on the Flop
Seat 2: sp2608 (big blind) collected ($47.50)



PokerStars Game #59851842854:  Hold'em No Limit ($2/$4 USD) - 2011/03/26 17:55:25 ET
Table 'Tucana VI' 2-max Seat #2 is the button
Seat 1: fightingnuns ($200 in chips) 
Seat 2: sp2608 ($692.60 in chips) 
sp2608: posts small blind $2
fightingnuns: posts big blind $4
*** HOLE CARDS ***
Dealt to fightingnuns [5c Qh]
sp2608: raises $12 to $16
fightingnuns: folds 
Uncalled bet ($12) returned to sp2608
sp2608 collected $8 from pot
*** SUMMARY ***
Total pot $8 | Rake $0 
Seat 1: fightingnuns (big blind) folded before Flop
Seat 2: sp2608 (button) (small blind) collected ($8)



PokerStars Game #59851850321:  Hold'em No Limit ($2/$4 USD) - 2011/03/26 17:55:35 ET
Table 'Tucana VI' 2-max Seat #1 is the button
Seat 1: fightingnuns ($200 in chips) 
Seat 2: sp2608 ($696.60 in chips) 
fightingnuns: posts small blind $2
sp2608: posts big blind $4
*** HOLE CARDS ***
Dealt to fightingnuns [Th 4h]
fightingnuns: raises $4 to $8
sp2608: calls $4
*** FLOP *** [Ah 5s 3h]
sp2608: bets $8
fightingnuns: calls $8
*** TURN *** [Ah 5s 3h] [9c]
sp2608: bets $12
fightingnuns: raises $24 to $36
sp2608: folds 
Uncalled bet ($24) returned to fightingnuns
fightingnuns collected $55.50 from pot
fightingnuns: doesn't show hand 
*** SUMMARY ***
Total pot $56 | Rake $0.50 
Board [Ah 5s 3h 9c]
Seat 1: fightingnuns (button) (small blind) collected ($55.50)
Seat 2: sp2608 (big blind) folded on the Turn



PokerStars Game #59851873777:  Hold'em No Limit ($2/$4 USD) - 2011/03/26 17:56:09 ET
Table 'Tucana VI' 2-max Seat #2 is the button
Seat 1: fightingnuns ($227.50 in chips) 
Seat 2: sp2608 ($668.60 in chips) 
sp2608: posts small blind $2
fightingnuns: posts big blind $4
*** HOLE CARDS ***
Dealt to fightingnuns [5c 9c]
sp2608: calls $2
fightingnuns: checks 
*** FLOP *** [3d 7d Ts]
fightingnuns: checks 
sp2608: bets $12
fightingnuns: folds 
Uncalled bet ($12) returned to sp2608
sp2608 collected $7.60 from pot
*** SUMMARY ***
Total pot $8 | Rake $0.40 
Board [3d 7d Ts]
Seat 1: fightingnuns (big blind) folded on the Flop
Seat 2: sp2608 (button) (small blind) collected ($7.60)



PokerStars Game #59851885890:  Hold'em No Limit ($2/$4 USD) - 2011/03/26 17:56:26 ET
Table 'Tucana VI' 2-max Seat #1 is the button
Seat 1: fightingnuns ($223.50 in chips) 
Seat 2: sp2608 ($672.20 in chips) 
fightingnuns: posts small blind $2
sp2608: posts big blind $4
*** HOLE CARDS ***
Dealt to fightingnuns [5d Qs]
fightingnuns: raises $4 to $8
sp2608: calls $4
*** FLOP *** [Jc Js Td]
sp2608: checks 
fightingnuns: bets $12
sp2608: raises $12 to $24
fightingnuns: raises $48 to $72
sp2608: raises $592.20 to $664.20 and is all-in
fightingnuns: folds 
Uncalled bet ($592.20) returned to sp2608
sp2608 collected $159.50 from pot
*** SUMMARY ***
Total pot $160 | Rake $0.50 
Board [Jc Js Td]
Seat 1: fightingnuns (button) (small blind) folded on the Flop
Seat 2: sp2608 (big blind) collected ($159.50)



PokerStars Game #59851904874:  Hold'em No Limit ($2/$4 USD) - 2011/03/26 17:56:54 ET
Table 'Tucana VI' 2-max Seat #2 is the button
Seat 1: fightingnuns ($200 in chips) 
Seat 2: sp2608 ($751.70 in chips) 
sp2608: posts small blind $2
fightingnuns: posts big blind $4
*** HOLE CARDS ***
Dealt to fightingnuns [Qd Ad]
sp2608: calls $2
fightingnuns: raises $12 to $16
sp2608: folds 
Uncalled bet ($12) returned to fightingnuns
fightingnuns collected $8 from pot
fightingnuns: doesn't show hand 
*** SUMMARY ***
Total pot $8 | Rake $0 
Seat 1: fightingnuns (big blind) collected ($8)
Seat 2: sp2608 (button) (small blind) folded before Flop



PokerStars Game #59851913841:  Hold'em No Limit ($2/$4 USD) - 2011/03/26 17:57:07 ET
Table 'Tucana VI' 2-max Seat #1 is the button
Seat 1: fightingnuns ($204 in chips) 
Seat 2: sp2608 ($747.70 in chips) 
fightingnuns: posts small blind $2
sp2608: posts big blind $4
*** HOLE CARDS ***
Dealt to fightingnuns [As Tc]
fightingnuns: raises $4 to $8
sp2608: calls $4
*** FLOP *** [Kh Td Jc]
sp2608: checks 
fightingnuns: checks 
*** TURN *** [Kh Td Jc] [4s]
sp2608: bets $8
fightingnuns: calls $8
*** RIVER *** [Kh Td Jc 4s] [Ah]
sp2608: checks 
fightingnuns: bets $20
sp2608: folds 
Uncalled bet ($20) returned to fightingnuns
fightingnuns collected $31.50 from pot
fightingnuns: doesn't show hand 
*** SUMMARY ***
Total pot $32 | Rake $0.50 
Board [Kh Td Jc 4s Ah]
Seat 1: fightingnuns (button) (small blind) collected ($31.50)
Seat 2: sp2608 (big blind) folded on the River



PokerStars Game #59851934819:  Hold'em No Limit ($2/$4 USD) - 2011/03/26 17:57:37 ET
Table 'Tucana VI' 2-max Seat #2 is the button
Seat 1: fightingnuns ($219.50 in chips) 
Seat 2: sp2608 ($731.70 in chips) 
sp2608: posts small blind $2
fightingnuns: posts big blind $4
*** HOLE CARDS ***
Dealt to fightingnuns [Jh Kd]
sp2608: raises $4 to $8
fightingnuns: raises $16 to $24
sp2608: raises $80 to $104
fightingnuns: folds 
Uncalled bet ($80) returned to sp2608
sp2608 collected $48 from pot
*** SUMMARY ***
Total pot $48 | Rake $0 
Seat 1: fightingnuns (big blind) folded before Flop
Seat 2: sp2608 (button) (small blind) collected ($48)



PokerStars Game #59851945836:  Hold'em No Limit ($2/$4 USD) - 2011/03/26 17:57:53 ET
Table 'Tucana VI' 2-max Seat #1 is the button
Seat 1: fightingnuns ($200 in chips) 
Seat 2: sp2608 ($755.70 in chips) 
fightingnuns: posts small blind $2
sp2608: posts big blind $4
*** HOLE CARDS ***
Dealt to fightingnuns [Qd 3h]
fightingnuns: folds 
Uncalled bet ($2) returned to sp2608
sp2608 collected $4 from pot
*** SUMMARY ***
Total pot $4 | Rake $0 
Seat 1: fightingnuns (button) (small blind) folded before Flop
Seat 2: sp2608 (big blind) collected ($4)



PokerStars Game #59851950610:  Hold'em No Limit ($2/$4 USD) - 2011/03/26 17:57:59 ET
Table 'Tucana VI' 2-max Seat #2 is the button
Seat 1: fightingnuns ($200 in chips) 
Seat 2: sp2608 ($757.70 in chips) 
sp2608: posts small blind $2
fightingnuns: posts big blind $4
*** HOLE CARDS ***
Dealt to fightingnuns [8h 2d]
sp2608: raises $4 to $8
fightingnuns: folds 
Uncalled bet ($4) returned to sp2608
sp2608 collected $8 from pot
*** SUMMARY ***
Total pot $8 | Rake $0 
Seat 1: fightingnuns (big blind) folded before Flop
Seat 2: sp2608 (button) (small blind) collected ($8)



PokerStars Game #59851956180:  Hold'em No Limit ($2/$4 USD) - 2011/03/26 17:58:07 ET
Table 'Tucana VI' 2-max Seat #1 is the button
Seat 1: fightingnuns ($200 in chips) 
Seat 2: sp2608 ($761.70 in chips) 
fightingnuns: posts small blind $2
sp2608: posts big blind $4
*** HOLE CARDS ***
Dealt to fightingnuns [7d 4h]
fightingnuns: folds 
Uncalled bet ($2) returned to sp2608
sp2608 collected $4 from pot
*** SUMMARY ***
Total pot $4 | Rake $0 
Seat 1: fightingnuns (button) (small blind) folded before Flop
Seat 2: sp2608 (big blind) collected ($4)



PokerStars Game #59851960175:  Hold'em No Limit ($2/$4 USD) - 2011/03/26 17:58:13 ET
Table 'Tucana VI' 2-max Seat #2 is the button
Seat 1: fightingnuns ($200 in chips) 
Seat 2: sp2608 ($763.70 in chips) 
sp2608: posts small blind $2
fightingnuns: posts big blind $4
*** HOLE CARDS ***
Dealt to fightingnuns [Qh 3h]
sp2608: raises $4 to $8
fightingnuns: folds 
Uncalled bet ($4) returned to sp2608
sp2608 collected $8 from pot
*** SUMMARY ***
Total pot $8 | Rake $0 
Seat 1: fightingnuns (big blind) folded before Flop
Seat 2: sp2608 (button) (small blind) collected ($8)



PokerStars Game #59851968115:  Hold'em No Limit ($2/$4 USD) - 2011/03/26 17:58:24 ET
Table 'Tucana VI' 2-max Seat #1 is the button
Seat 1: fightingnuns ($200 in chips) 
Seat 2: sp2608 ($767.70 in chips) 
fightingnuns: posts small blind $2
sp2608: posts big blind $4
*** HOLE CARDS ***
Dealt to fightingnuns [3d 5s]
fightingnuns: folds 
Uncalled bet ($2) returned to sp2608
sp2608 collected $4 from pot
*** SUMMARY ***
Total pot $4 | Rake $0 
Seat 1: fightingnuns (button) (small blind) folded before Flop
Seat 2: sp2608 (big blind) collected ($4)



PokerStars Game #59851971881:  Hold'em No Limit ($2/$4 USD) - 2011/03/26 17:58:30 ET
Table 'Tucana VI' 2-max Seat #2 is the button
Seat 1: fightingnuns ($200 in chips) 
Seat 2: sp2608 ($769.70 in chips) 
sp2608: posts small blind $2
fightingnuns: posts big blind $4
*** HOLE CARDS ***
Dealt to fightingnuns [Ks Kh]
sp2608: calls $2
fightingnuns: raises $12 to $16
sp2608: folds 
Uncalled bet ($12) returned to fightingnuns
fightingnuns collected $8 from pot
fightingnuns: doesn't show hand 
*** SUMMARY ***
Total pot $8 | Rake $0 
Seat 1: fightingnuns (big blind) collected ($8)
Seat 2: sp2608 (button) (small blind) folded before Flop



PokerStars Game #59851980005:  Hold'em No Limit ($2/$4 USD) - 2011/03/26 17:58:42 ET
Table 'Tucana VI' 2-max Seat #1 is the button
Seat 1: fightingnuns ($204 in chips) 
Seat 2: sp2608 ($765.70 in chips) 
fightingnuns: posts small blind $2
sp2608: posts big blind $4
*** HOLE CARDS ***
Dealt to fightingnuns [Js 9h]
fightingnuns: raises $4 to $8
sp2608: calls $4
*** FLOP *** [Ac Qc 4s]
sp2608: checks 
fightingnuns: bets $12
sp2608: folds 
Uncalled bet ($12) returned to fightingnuns
fightingnuns collected $15.50 from pot
fightingnuns: doesn't show hand 
*** SUMMARY ***
Total pot $16 | Rake $0.50 
Board [Ac Qc 4s]
Seat 1: fightingnuns (button) (small blind) collected ($15.50)
Seat 2: sp2608 (big blind) folded on the Flop



PokerStars Game #59851993406:  Hold'em No Limit ($2/$4 USD) - 2011/03/26 17:59:00 ET
Table 'Tucana VI' 2-max Seat #2 is the button
Seat 1: fightingnuns ($211.50 in chips) 
Seat 2: sp2608 ($757.70 in chips) 
sp2608: posts small blind $2
fightingnuns: posts big blind $4
*** HOLE CARDS ***
Dealt to fightingnuns [Tc 7s]
sp2608: raises $4 to $8
fightingnuns: folds 
Uncalled bet ($4) returned to sp2608
sp2608 collected $8 from pot
*** SUMMARY ***
Total pot $8 | Rake $0 
Seat 1: fightingnuns (big blind) folded before Flop
Seat 2: sp2608 (button) (small blind) collected ($8)



PokerStars Game #59851999674:  Hold'em No Limit ($2/$4 USD) - 2011/03/26 17:59:09 ET
Table 'Tucana VI' 2-max Seat #1 is the button
Seat 1: fightingnuns ($207.50 in chips) 
Seat 2: sp2608 ($761.70 in chips) 
fightingnuns: posts small blind $2
sp2608: posts big blind $4
*** HOLE CARDS ***
Dealt to fightingnuns [Kd 4h]
fightingnuns: raises $4 to $8
sp2608: calls $4
*** FLOP *** [7c Kc 9c]
sp2608: checks 
fightingnuns: checks 
*** TURN *** [7c Kc 9c] [Js]
sp2608: checks 
fightingnuns: bets $12
sp2608: folds 
Uncalled bet ($12) returned to fightingnuns
fightingnuns collected $15.50 from pot
fightingnuns: doesn't show hand 
*** SUMMARY ***
Total pot $16 | Rake $0.50 
Board [7c Kc 9c Js]
Seat 1: fightingnuns (button) (small blind) collected ($15.50)
Seat 2: sp2608 (big blind) folded on the Turn



PokerStars Game #59852016285:  Hold'em No Limit ($2/$4 USD) - 2011/03/26 17:59:33 ET
Table 'Tucana VI' 2-max Seat #2 is the button
Seat 1: fightingnuns ($215 in chips) 
Seat 2: sp2608 ($753.70 in chips) 
sp2608: posts small blind $2
fightingnuns: posts big blind $4
*** HOLE CARDS ***
Dealt to fightingnuns [8d As]
sp2608: folds 
Uncalled bet ($2) returned to fightingnuns
fightingnuns collected $4 from pot
fightingnuns: doesn't show hand 
*** SUMMARY ***
Total pot $4 | Rake $0 
Seat 1: fightingnuns (big blind) collected ($4)
Seat 2: sp2608 (button) (small blind) folded before Flop



PokerStars Game #59852020406:  Hold'em No Limit ($2/$4 USD) - 2011/03/26 17:59:39 ET
Table 'Tucana VI' 2-max Seat #1 is the button
Seat 1: fightingnuns ($217 in chips) 
Seat 2: sp2608 ($751.70 in chips) 
fightingnuns: posts small blind $2
sp2608: posts big blind $4
*** HOLE CARDS ***
Dealt to fightingnuns [9c As]
fightingnuns: raises $4 to $8
sp2608: raises $20 to $28
fightingnuns: folds 
Uncalled bet ($20) returned to sp2608
sp2608 collected $16 from pot
*** SUMMARY ***
Total pot $16 | Rake $0 
Seat 1: fightingnuns (button) (small blind) folded before Flop
Seat 2: sp2608 (big blind) collected ($16)



PokerStars Game #59852028815:  Hold'em No Limit ($2/$4 USD) - 2011/03/26 17:59:51 ET
Table 'Tucana VI' 2-max Seat #2 is the button
Seat 1: fightingnuns ($209 in chips) 
Seat 2: sp2608 ($759.70 in chips) 
sp2608: posts small blind $2
fightingnuns: posts big blind $4
*** HOLE CARDS ***
Dealt to fightingnuns [9s Qs]
sp2608: raises $8 to $12
fightingnuns: calls $8
*** FLOP *** [8s 6s 7d]
fightingnuns: bets $16
sp2608: calls $16
*** TURN *** [8s 6s 7d] [Tc]
fightingnuns: checks 
sp2608: checks 
*** RIVER *** [8s 6s 7d Tc] [2s]
fightingnuns: bets $48
sp2608: folds 
Uncalled bet ($48) returned to fightingnuns
fightingnuns collected $55.50 from pot
fightingnuns: doesn't show hand 
*** SUMMARY ***
Total pot $56 | Rake $0.50 
Board [8s 6s 7d Tc 2s]
Seat 1: fightingnuns (big blind) collected ($55.50)
Seat 2: sp2608 (button) (small blind) folded on the River



PokerStars Game #59852051168:  Hold'em No Limit ($2/$4 USD) - 2011/03/26 18:00:20 ET
Table 'Tucana VI' 2-max Seat #1 is the button
Seat 1: fightingnuns ($236.50 in chips) 
Seat 2: sp2608 ($731.70 in chips) 
fightingnuns: posts small blind $2
sp2608: posts big blind $4
*** HOLE CARDS ***
Dealt to fightingnuns [2h Ah]
fightingnuns: raises $4 to $8
sp2608: calls $4
*** FLOP *** [4s 2c Ks]
sp2608: checks 
fightingnuns: checks 
*** TURN *** [4s 2c Ks] [Ts]
sp2608: bets $12
fightingnuns: folds 
Uncalled bet ($12) returned to sp2608
sp2608 collected $15.50 from pot
*** SUMMARY ***
Total pot $16 | Rake $0.50 
Board [4s 2c Ks Ts]
Seat 1: fightingnuns (button) (small blind) folded on the Turn
Seat 2: sp2608 (big blind) collected ($15.50)



PokerStars Game #59852068410:  Hold'em No Limit ($2/$4 USD) - 2011/03/26 18:00:43 ET
Table 'Tucana VI' 2-max Seat #2 is the button
Seat 1: fightingnuns ($228.50 in chips) 
Seat 2: sp2608 ($739.20 in chips) 
sp2608: posts small blind $2
fightingnuns: posts big blind $4
*** HOLE CARDS ***
Dealt to fightingnuns [4c Kd]
sp2608: raises $4 to $8
fightingnuns: folds 
Uncalled bet ($4) returned to sp2608
sp2608 collected $8 from pot
*** SUMMARY ***
Total pot $8 | Rake $0 
Seat 1: fightingnuns (big blind) folded before Flop
Seat 2: sp2608 (button) (small blind) collected ($8)



PokerStars Game #59852075328:  Hold'em No Limit ($2/$4 USD) - 2011/03/26 18:00:52 ET
Table 'Tucana VI' 2-max Seat #1 is the button
Seat 1: fightingnuns ($224.50 in chips) 
Seat 2: sp2608 ($743.20 in chips) 
fightingnuns: posts small blind $2
sp2608: posts big blind $4
*** HOLE CARDS ***
Dealt to fightingnuns [5c 9s]
fightingnuns: raises $4 to $8
sp2608: calls $4
*** FLOP *** [7s 3s 6h]
sp2608: bets $12
fightingnuns: raises $24 to $36
sp2608: calls $24
*** TURN *** [7s 3s 6h] [9c]
sp2608: checks 
fightingnuns: checks 
*** RIVER *** [7s 3s 6h 9c] [5h]
sp2608: bets $88
fightingnuns: folds 
Uncalled bet ($88) returned to sp2608
sp2608 collected $87.50 from pot
*** SUMMARY ***
Total pot $88 | Rake $0.50 
Board [7s 3s 6h 9c 5h]
Seat 1: fightingnuns (button) (small blind) folded on the River
Seat 2: sp2608 (big blind) collected ($87.50)



PokerStars Game #59852106883:  Hold'em No Limit ($2/$4 USD) - 2011/03/26 18:01:31 ET
Table 'Tucana VI' 2-max Seat #2 is the button
Seat 1: fightingnuns ($200 in chips) 
Seat 2: sp2608 ($786.70 in chips) 
sp2608: posts small blind $2
fightingnuns: posts big blind $4
*** HOLE CARDS ***
Dealt to fightingnuns [4c 7h]
sp2608: folds 
Uncalled bet ($2) returned to fightingnuns
fightingnuns collected $4 from pot
fightingnuns: doesn't show hand 
*** SUMMARY ***
Total pot $4 | Rake $0 
Seat 1: fightingnuns (big blind) collected ($4)
Seat 2: sp2608 (button) (small blind) folded before Flop



PokerStars Game #59852112560:  Hold'em No Limit ($2/$4 USD) - 2011/03/26 18:01:37 ET
Table 'Tucana VI' 2-max Seat #1 is the button
Seat 1: fightingnuns ($202 in chips) 
Seat 2: sp2608 ($784.70 in chips) 
fightingnuns: posts small blind $2
sp2608: posts big blind $4
*** HOLE CARDS ***
Dealt to fightingnuns [Jh Qc]
fightingnuns: raises $4 to $8
sp2608: folds 
Uncalled bet ($4) returned to fightingnuns
fightingnuns collected $8 from pot
fightingnuns: doesn't show hand 
*** SUMMARY ***
Total pot $8 | Rake $0 
Seat 1: fightingnuns (button) (small blind) collected ($8)
Seat 2: sp2608 (big blind) folded before Flop



PokerStars Game #59852118766:  Hold'em No Limit ($2/$4 USD) - 2011/03/26 18:01:44 ET
Table 'Tucana VI' 2-max Seat #2 is the button
Seat 1: fightingnuns ($206 in chips) 
Seat 2: sp2608 ($780.70 in chips) 
sp2608: posts small blind $2
fightingnuns: posts big blind $4
*** HOLE CARDS ***
Dealt to fightingnuns [Tc 5c]
sp2608: calls $2
fightingnuns: checks 
*** FLOP *** [Qd 4h Td]
fightingnuns: checks 
sp2608: checks 
*** TURN *** [Qd 4h Td] [Ad]
fightingnuns: checks 
sp2608: checks 
*** RIVER *** [Qd 4h Td Ad] [Jc]
fightingnuns: checks 
sp2608: checks 
*** SHOW DOWN ***
fightingnuns: shows [Tc 5c] (a pair of Tens)
sp2608: mucks hand 
fightingnuns collected $7.60 from pot
*** SUMMARY ***
Total pot $8 | Rake $0.40 
Board [Qd 4h Td Ad Jc]
Seat 1: fightingnuns (big blind) showed [Tc 5c] and won ($7.60) with a pair of Tens
Seat 2: sp2608 (button) (small blind) mucked [7d 6s]



PokerStars Game #59852140105:  Hold'em No Limit ($2/$4 USD) - 2011/03/26 18:02:07 ET
Table 'Tucana VI' 2-max Seat #1 is the button
Seat 1: fightingnuns ($209.60 in chips) 
Seat 2: sp2608 ($776.70 in chips) 
fightingnuns: posts small blind $2
sp2608: posts big blind $4
*** HOLE CARDS ***
Dealt to fightingnuns [4d Qc]
fightingnuns: raises $4 to $8
sp2608: calls $4
*** FLOP *** [4s Jh 9d]
sp2608: bets $12
fightingnuns: folds 
Uncalled bet ($12) returned to sp2608
sp2608 collected $15.50 from pot
*** SUMMARY ***
Total pot $16 | Rake $0.50 
Board [4s Jh 9d]
Seat 1: fightingnuns (button) (small blind) folded on the Flop
Seat 2: sp2608 (big blind) collected ($15.50)



PokerStars Game #59852157577:  Hold'em No Limit ($2/$4 USD) - 2011/03/26 18:02:27 ET
Table 'Tucana VI' 2-max Seat #2 is the button
Seat 1: fightingnuns ($201.60 in chips) 
Seat 2: sp2608 ($784.20 in chips) 
sp2608: posts small blind $2
fightingnuns: posts big blind $4
*** HOLE CARDS ***
Dealt to fightingnuns [7c 3h]
sp2608: raises $4 to $8
fightingnuns: folds 
Uncalled bet ($4) returned to sp2608
sp2608 collected $8 from pot
*** SUMMARY ***
Total pot $8 | Rake $0 
Seat 1: fightingnuns (big blind) folded before Flop
Seat 2: sp2608 (button) (small blind) collected ($8)



PokerStars Game #59852166211:  Hold'em No Limit ($2/$4 USD) - 2011/03/26 18:02:36 ET
Table 'Tucana VI' 2-max Seat #1 is the button
Seat 1: fightingnuns ($200 in chips) 
Seat 2: sp2608 ($788.20 in chips) 
fightingnuns: posts small blind $2
sp2608: posts big blind $4
*** HOLE CARDS ***
Dealt to fightingnuns [3h 4s]
fightingnuns: folds 
Uncalled bet ($2) returned to sp2608
sp2608 collected $4 from pot
*** SUMMARY ***
Total pot $4 | Rake $0 
Seat 1: fightingnuns (button) (small blind) folded before Flop
Seat 2: sp2608 (big blind) collected ($4)



PokerStars Game #59852171298:  Hold'em No Limit ($2/$4 USD) - 2011/03/26 18:02:42 ET
Table 'Tucana VI' 2-max Seat #2 is the button
Seat 1: fightingnuns ($200 in chips) 
Seat 2: sp2608 ($790.20 in chips) 
sp2608: posts small blind $2
fightingnuns: posts big blind $4
*** HOLE CARDS ***
Dealt to fightingnuns [Kd Qs]
sp2608: raises $8 to $12
fightingnuns: calls $8
*** FLOP *** [8d Js 4s]
fightingnuns: checks 
sp2608: bets $24
fightingnuns: folds 
Uncalled bet ($24) returned to sp2608
sp2608 collected $23.50 from pot
*** SUMMARY ***
Total pot $24 | Rake $0.50 
Board [8d Js 4s]
Seat 1: fightingnuns (big blind) folded on the Flop
Seat 2: sp2608 (button) (small blind) collected ($23.50)



PokerStars Game #59852187653:  Hold'em No Limit ($2/$4 USD) - 2011/03/26 18:03:00 ET
Table 'Tucana VI' 2-max Seat #1 is the button
Seat 1: fightingnuns ($200 in chips) 
Seat 2: sp2608 ($801.70 in chips) 
fightingnuns: posts small blind $2
sp2608: posts big blind $4
*** HOLE CARDS ***
Dealt to fightingnuns [2h 7s]
fightingnuns: folds 
Uncalled bet ($2) returned to sp2608
sp2608 collected $4 from pot
*** SUMMARY ***
Total pot $4 | Rake $0 
Seat 1: fightingnuns (button) (small blind) folded before Flop
Seat 2: sp2608 (big blind) collected ($4)



PokerStars Game #59852193054:  Hold'em No Limit ($2/$4 USD) - 2011/03/26 18:03:06 ET
Table 'Tucana VI' 2-max Seat #2 is the button
Seat 1: fightingnuns ($200 in chips) 
Seat 2: sp2608 ($803.70 in chips) 
sp2608: posts small blind $2
fightingnuns: posts big blind $4
*** HOLE CARDS ***
Dealt to fightingnuns [Qc 7h]
sp2608: calls $2
fightingnuns: raises $12 to $16
sp2608: calls $12
*** FLOP *** [4h 8c 6d]
fightingnuns: bets $20
sp2608: folds 
Uncalled bet ($20) returned to fightingnuns
fightingnuns collected $31.50 from pot
fightingnuns: doesn't show hand 
*** SUMMARY ***
Total pot $32 | Rake $0.50 
Board [4h 8c 6d]
Seat 1: fightingnuns (big blind) collected ($31.50)
Seat 2: sp2608 (button) (small blind) folded on the Flop



PokerStars Game #59852208609:  Hold'em No Limit ($2/$4 USD) - 2011/03/26 18:03:23 ET
Table 'Tucana VI' 2-max Seat #1 is the button
Seat 1: fightingnuns ($215.50 in chips) 
Seat 2: sp2608 ($787.70 in chips) 
fightingnuns: posts small blind $2
sp2608: posts big blind $4
*** HOLE CARDS ***
Dealt to fightingnuns [8c 9s]
fightingnuns: raises $4 to $8
sp2608: calls $4
*** FLOP *** [Jd Jh 2c]
sp2608: checks 
fightingnuns: bets $12
sp2608: folds 
Uncalled bet ($12) returned to fightingnuns
fightingnuns collected $15.50 from pot
fightingnuns: doesn't show hand 
*** SUMMARY ***
Total pot $16 | Rake $0.50 
Board [Jd Jh 2c]
Seat 1: fightingnuns (button) (small blind) collected ($15.50)
Seat 2: sp2608 (big blind) folded on the Flop



PokerStars Game #59852223605:  Hold'em No Limit ($2/$4 USD) - 2011/03/26 18:03:38 ET
Table 'Tucana VI' 2-max Seat #2 is the button
Seat 1: fightingnuns ($223 in chips) 
Seat 2: sp2608 ($779.70 in chips) 
sp2608: posts small blind $2
fightingnuns: posts big blind $4
*** HOLE CARDS ***
Dealt to fightingnuns [5s 3d]
sp2608: raises $4 to $8
fightingnuns: folds 
Uncalled bet ($4) returned to sp2608
sp2608 collected $8 from pot
*** SUMMARY ***
Total pot $8 | Rake $0 
Seat 1: fightingnuns (big blind) folded before Flop
Seat 2: sp2608 (button) (small blind) collected ($8)



PokerStars Game #59852234129:  Hold'em No Limit ($2/$4 USD) - 2011/03/26 18:03:49 ET
Table 'Tucana VI' 2-max Seat #1 is the button
Seat 1: fightingnuns ($219 in chips) 
Seat 2: sp2608 ($783.70 in chips) 
fightingnuns: posts small blind $2
sp2608: posts big blind $4
*** HOLE CARDS ***
Dealt to fightingnuns [8d Jd]
fightingnuns: raises $4 to $8
sp2608: calls $4
*** FLOP *** [Ac Th 6d]
sp2608: checks 
fightingnuns: bets $12
sp2608: folds 
Uncalled bet ($12) returned to fightingnuns
fightingnuns collected $15.50 from pot
fightingnuns: doesn't show hand 
*** SUMMARY ***
Total pot $16 | Rake $0.50 
Board [Ac Th 6d]
Seat 1: fightingnuns (button) (small blind) collected ($15.50)
Seat 2: sp2608 (big blind) folded on the Flop



PokerStars Game #59852257053:  Hold'em No Limit ($2/$4 USD) - 2011/03/26 18:04:13 ET
Table 'Tucana VI' 2-max Seat #2 is the button
Seat 1: fightingnuns ($226.50 in chips) 
Seat 2: sp2608 ($775.70 in chips) 
sp2608: posts small blind $2
fightingnuns: posts big blind $4
*** HOLE CARDS ***
Dealt to fightingnuns [Kc 7d]
sp2608: raises $4 to $8
fightingnuns: folds 
Uncalled bet ($4) returned to sp2608
sp2608 collected $8 from pot
*** SUMMARY ***
Total pot $8 | Rake $0 
Seat 1: fightingnuns (big blind) folded before Flop
Seat 2: sp2608 (button) (small blind) collected ($8)



PokerStars Game #59852264538:  Hold'em No Limit ($2/$4 USD) - 2011/03/26 18:04:21 ET
Table 'Tucana VI' 2-max Seat #1 is the button
Seat 1: fightingnuns ($222.50 in chips) 
Seat 2: sp2608 ($779.70 in chips) 
fightingnuns: posts small blind $2
sp2608: posts big blind $4
*** HOLE CARDS ***
Dealt to fightingnuns [As Qh]
fightingnuns: raises $4 to $8
sp2608: calls $4
*** FLOP *** [3c Kc Jh]
sp2608: checks 
fightingnuns: checks 
*** TURN *** [3c Kc Jh] [2d]
sp2608: checks 
fightingnuns: checks 
*** RIVER *** [3c Kc Jh 2d] [Qd]
sp2608: checks 
fightingnuns: bets $12
sp2608: folds 
Uncalled bet ($12) returned to fightingnuns
fightingnuns collected $15.50 from pot
fightingnuns: doesn't show hand 
*** SUMMARY ***
Total pot $16 | Rake $0.50 
Board [3c Kc Jh 2d Qd]
Seat 1: fightingnuns (button) (small blind) collected ($15.50)
Seat 2: sp2608 (big blind) folded on the River



PokerStars Game #59852292992:  Hold'em No Limit ($2/$4 USD) - 2011/03/26 18:04:51 ET
Table 'Tucana VI' 2-max Seat #2 is the button
Seat 1: fightingnuns ($230 in chips) 
Seat 2: sp2608 ($771.70 in chips) 
sp2608: posts small blind $2
fightingnuns: posts big blind $4
*** HOLE CARDS ***
Dealt to fightingnuns [Kd Ts]
sp2608: calls $2
fightingnuns: raises $12 to $16
sp2608: folds 
Uncalled bet ($12) returned to fightingnuns
fightingnuns collected $8 from pot
fightingnuns: doesn't show hand 
*** SUMMARY ***
Total pot $8 | Rake $0 
Seat 1: fightingnuns (big blind) collected ($8)
Seat 2: sp2608 (button) (small blind) folded before Flop



PokerStars Game #59852306397:  Hold'em No Limit ($2/$4 USD) - 2011/03/26 18:05:05 ET
Table 'Tucana VI' 2-max Seat #1 is the button
Seat 1: fightingnuns ($234 in chips) 
Seat 2: sp2608 ($767.70 in chips) 
fightingnuns: posts small blind $2
sp2608: posts big blind $4
*** HOLE CARDS ***
Dealt to fightingnuns [6h Kc]
fightingnuns: raises $4 to $8
sp2608: calls $4
*** FLOP *** [7s 2s 8h]
sp2608: checks 
fightingnuns: checks 
*** TURN *** [7s 2s 8h] [3h]
sp2608: bets $8
fightingnuns: folds 
Uncalled bet ($8) returned to sp2608
sp2608 collected $15.50 from pot
*** SUMMARY ***
Total pot $16 | Rake $0.50 
Board [7s 2s 8h 3h]
Seat 1: fightingnuns (button) (small blind) folded on the Turn
Seat 2: sp2608 (big blind) collected ($15.50)



PokerStars Game #59852325060:  Hold'em No Limit ($2/$4 USD) - 2011/03/26 18:05:24 ET
Table 'Tucana VI' 2-max Seat #2 is the button
Seat 1: fightingnuns ($226 in chips) 
Seat 2: sp2608 ($775.20 in chips) 
sp2608: posts small blind $2
fightingnuns: posts big blind $4
*** HOLE CARDS ***
Dealt to fightingnuns [Qd 6d]
sp2608: calls $2
fightingnuns: checks 
*** FLOP *** [Ah 6s Kd]
fightingnuns: checks 
sp2608: bets $12
fightingnuns: folds 
Uncalled bet ($12) returned to sp2608
sp2608 collected $7.60 from pot
*** SUMMARY ***
Total pot $8 | Rake $0.40 
Board [Ah 6s Kd]
Seat 1: fightingnuns (big blind) folded on the Flop
Seat 2: sp2608 (button) (small blind) collected ($7.60)



PokerStars Game #59852341165:  Hold'em No Limit ($2/$4 USD) - 2011/03/26 18:05:41 ET
Table 'Tucana VI' 2-max Seat #1 is the button
Seat 1: fightingnuns ($222 in chips) 
Seat 2: sp2608 ($778.80 in chips) 
fightingnuns: posts small blind $2
sp2608: posts big blind $4
*** HOLE CARDS ***
Dealt to fightingnuns [8h Ac]
fightingnuns: raises $8 to $12
sp2608: calls $8
*** FLOP *** [9c Ts Ah]
sp2608: bets $12
fightingnuns: raises $24 to $36
sp2608: calls $24
*** TURN *** [9c Ts Ah] [5d]
sp2608: checks 
fightingnuns: checks 
*** RIVER *** [9c Ts Ah 5d] [5c]
sp2608: checks 
fightingnuns: bets $44
sp2608: folds 
Uncalled bet ($44) returned to fightingnuns
fightingnuns collected $95.50 from pot
fightingnuns: doesn't show hand 
*** SUMMARY ***
Total pot $96 | Rake $0.50 
Board [9c Ts Ah 5d 5c]
Seat 1: fightingnuns (button) (small blind) collected ($95.50)
Seat 2: sp2608 (big blind) folded on the River



PokerStars Game #59852380431:  Hold'em No Limit ($2/$4 USD) - 2011/03/26 18:06:22 ET
Table 'Tucana VI' 2-max Seat #2 is the button
Seat 1: fightingnuns ($269.50 in chips) 
Seat 2: sp2608 ($730.80 in chips) 
sp2608: posts small blind $2
fightingnuns: posts big blind $4
*** HOLE CARDS ***
Dealt to fightingnuns [Tc 3h]
sp2608: raises $4 to $8
fightingnuns: folds 
Uncalled bet ($4) returned to sp2608
sp2608 collected $8 from pot
*** SUMMARY ***
Total pot $8 | Rake $0 
Seat 1: fightingnuns (big blind) folded before Flop
Seat 2: sp2608 (button) (small blind) collected ($8)



PokerStars Game #59852388118:  Hold'em No Limit ($2/$4 USD) - 2011/03/26 18:06:30 ET
Table 'Tucana VI' 2-max Seat #1 is the button
Seat 1: fightingnuns ($265.50 in chips) 
Seat 2: sp2608 ($734.80 in chips) 
fightingnuns: posts small blind $2
sp2608: posts big blind $4
*** HOLE CARDS ***
Dealt to fightingnuns [Qd 8h]
fightingnuns: raises $4 to $8
sp2608: folds 
Uncalled bet ($4) returned to fightingnuns
fightingnuns collected $8 from pot
fightingnuns: doesn't show hand 
*** SUMMARY ***
Total pot $8 | Rake $0 
Seat 1: fightingnuns (button) (small blind) collected ($8)
Seat 2: sp2608 (big blind) folded before Flop



PokerStars Game #59852398412:  Hold'em No Limit ($2/$4 USD) - 2011/03/26 18:06:41 ET
Table 'Tucana VI' 2-max Seat #2 is the button
Seat 1: fightingnuns ($269.50 in chips) 
Seat 2: sp2608 ($730.80 in chips) 
sp2608: posts small blind $2
fightingnuns: posts big blind $4
*** HOLE CARDS ***
Dealt to fightingnuns [Jc Th]
sp2608: calls $2
fightingnuns: raises $12 to $16
sp2608: calls $12
*** FLOP *** [Qc Td 4s]
fightingnuns: checks 
sp2608: bets $60
fightingnuns: folds 
Uncalled bet ($60) returned to sp2608
sp2608 collected $31.50 from pot
*** SUMMARY ***
Total pot $32 | Rake $0.50 
Board [Qc Td 4s]
Seat 1: fightingnuns (big blind) folded on the Flop
Seat 2: sp2608 (button) (small blind) collected ($31.50)



PokerStars Game #59852422051:  Hold'em No Limit ($2/$4 USD) - 2011/03/26 18:07:05 ET
Table 'Tucana VI' 2-max Seat #1 is the button
Seat 1: fightingnuns ($253.50 in chips) 
Seat 2: sp2608 ($746.30 in chips) 
fightingnuns: posts small blind $2
sp2608: posts big blind $4
*** HOLE CARDS ***
Dealt to fightingnuns [Tc 6h]
fightingnuns: folds 
Uncalled bet ($2) returned to sp2608
sp2608 collected $4 from pot
*** SUMMARY ***
Total pot $4 | Rake $0 
Seat 1: fightingnuns (button) (small blind) folded before Flop
Seat 2: sp2608 (big blind) collected ($4)



PokerStars Game #59852428631:  Hold'em No Limit ($2/$4 USD) - 2011/03/26 18:07:12 ET
Table 'Tucana VI' 2-max Seat #2 is the button
Seat 1: fightingnuns ($251.50 in chips) 
Seat 2: sp2608 ($748.30 in chips) 
sp2608: posts small blind $2
fightingnuns: posts big blind $4
*** HOLE CARDS ***
Dealt to fightingnuns [8h 2d]
sp2608: folds 
Uncalled bet ($2) returned to fightingnuns
fightingnuns collected $4 from pot
fightingnuns: doesn't show hand 
*** SUMMARY ***
Total pot $4 | Rake $0 
Seat 1: fightingnuns (big blind) collected ($4)
Seat 2: sp2608 (button) (small blind) folded before Flop



PokerStars Game #59852437681:  Hold'em No Limit ($2/$4 USD) - 2011/03/26 18:07:22 ET
Table 'Tucana VI' 2-max Seat #1 is the button
Seat 1: fightingnuns ($253.50 in chips) 
Seat 2: sp2608 ($746.30 in chips) 
fightingnuns: posts small blind $2
sp2608: posts big blind $4
*** HOLE CARDS ***
Dealt to fightingnuns [Ts Jd]
fightingnuns: raises $4 to $8
sp2608: raises $4 to $12
fightingnuns: calls $4
*** FLOP *** [Ah 4h 3d]
sp2608: checks 
fightingnuns: checks 
*** TURN *** [Ah 4h 3d] [Ad]
sp2608: bets $28
fightingnuns: folds 
Uncalled bet ($28) returned to sp2608
sp2608 collected $23.50 from pot
*** SUMMARY ***
Total pot $24 | Rake $0.50 
Board [Ah 4h 3d Ad]
Seat 1: fightingnuns (button) (small blind) folded on the Turn
Seat 2: sp2608 (big blind) collected ($23.50)



PokerStars Game #59852459206:  Hold'em No Limit ($2/$4 USD) - 2011/03/26 18:07:44 ET
Table 'Tucana VI' 2-max Seat #2 is the button
Seat 1: fightingnuns ($241.50 in chips) 
Seat 2: sp2608 ($757.80 in chips) 
sp2608: posts small blind $2
fightingnuns: posts big blind $4
*** HOLE CARDS ***
Dealt to fightingnuns [9c 4h]
sp2608: calls $2
fightingnuns: checks 
*** FLOP *** [Jd 7h 2c]
fightingnuns: checks 
sp2608: checks 
*** TURN *** [Jd 7h 2c] [9h]
fightingnuns: bets $8
sp2608: folds 
Uncalled bet ($8) returned to fightingnuns
fightingnuns collected $7.60 from pot
fightingnuns: doesn't show hand 
*** SUMMARY ***
Total pot $8 | Rake $0.40 
Board [Jd 7h 2c 9h]
Seat 1: fightingnuns (big blind) collected ($7.60)
Seat 2: sp2608 (button) (small blind) folded on the Turn



PokerStars Game #59852475706:  Hold'em No Limit ($2/$4 USD) - 2011/03/26 18:08:01 ET
Table 'Tucana VI' 2-max Seat #1 is the button
Seat 1: fightingnuns ($245.10 in chips) 
Seat 2: sp2608 ($753.80 in chips) 
fightingnuns: posts small blind $2
sp2608: posts big blind $4
*** HOLE CARDS ***
Dealt to fightingnuns [Kh Jh]
fightingnuns: raises $4 to $8
sp2608: calls $4
*** FLOP *** [5d 7c Ts]
sp2608: checks 
fightingnuns: bets $12
sp2608: folds 
Uncalled bet ($12) returned to fightingnuns
fightingnuns collected $15.50 from pot
fightingnuns: doesn't show hand 
*** SUMMARY ***
Total pot $16 | Rake $0.50 
Board [5d 7c Ts]
Seat 1: fightingnuns (button) (small blind) collected ($15.50)
Seat 2: sp2608 (big blind) folded on the Flop



PokerStars Game #59852497233:  Hold'em No Limit ($2/$4 USD) - 2011/03/26 18:08:24 ET
Table 'Tucana VI' 2-max Seat #2 is the button
Seat 1: fightingnuns ($252.60 in chips) 
Seat 2: sp2608 ($745.80 in chips) 
sp2608: posts small blind $2
fightingnuns: posts big blind $4
*** HOLE CARDS ***
Dealt to fightingnuns [9h Ac]
sp2608: calls $2
fightingnuns: raises $12 to $16
sp2608: calls $12
*** FLOP *** [Th Qs 9d]
fightingnuns: bets $20
sp2608: raises $20 to $40
fightingnuns: folds 
Uncalled bet ($20) returned to sp2608
sp2608 collected $71.50 from pot
*** SUMMARY ***
Total pot $72 | Rake $0.50 
Board [Th Qs 9d]
Seat 1: fightingnuns (big blind) folded on the Flop
Seat 2: sp2608 (button) (small blind) collected ($71.50)



PokerStars Game #59852518192:  Hold'em No Limit ($2/$4 USD) - 2011/03/26 18:08:46 ET
Table 'Tucana VI' 2-max Seat #1 is the button
Seat 1: fightingnuns ($216.60 in chips) 
Seat 2: sp2608 ($781.30 in chips) 
fightingnuns: posts small blind $2
sp2608: posts big blind $4
*** HOLE CARDS ***
Dealt to fightingnuns [9c Qs]
fightingnuns: raises $8 to $12
sp2608: raises $8 to $20
fightingnuns: calls $8
*** FLOP *** [Kd 3h 2h]
sp2608: bets $32
fightingnuns: folds 
Uncalled bet ($32) returned to sp2608
sp2608 collected $39.50 from pot
*** SUMMARY ***
Total pot $40 | Rake $0.50 
Board [Kd 3h 2h]
Seat 1: fightingnuns (button) (small blind) folded on the Flop
Seat 2: sp2608 (big blind) collected ($39.50)



PokerStars Game #59852536492:  Hold'em No Limit ($2/$4 USD) - 2011/03/26 18:09:05 ET
Table 'Tucana VI' 2-max Seat #2 is the button
Seat 1: fightingnuns ($200 in chips) 
Seat 2: sp2608 ($800.80 in chips) 
sp2608: posts small blind $2
fightingnuns: posts big blind $4
*** HOLE CARDS ***
Dealt to fightingnuns [Ad 3c]
sp2608: calls $2
fightingnuns: checks 
*** FLOP *** [4c 5d 4s]
fightingnuns: checks 
sp2608: bets $16
fightingnuns: folds 
Uncalled bet ($16) returned to sp2608
sp2608 collected $7.60 from pot
*** SUMMARY ***
Total pot $8 | Rake $0.40 
Board [4c 5d 4s]
Seat 1: fightingnuns (big blind) folded on the Flop
Seat 2: sp2608 (button) (small blind) collected ($7.60)



PokerStars Game #59852551673:  Hold'em No Limit ($2/$4 USD) - 2011/03/26 18:09:21 ET
Table 'Tucana VI' 2-max Seat #1 is the button
Seat 1: fightingnuns ($200 in chips) 
Seat 2: sp2608 ($804.40 in chips) 
fightingnuns: posts small blind $2
sp2608: posts big blind $4
*** HOLE CARDS ***
Dealt to fightingnuns [Qd 5c]
fightingnuns: folds 
Uncalled bet ($2) returned to sp2608
sp2608 collected $4 from pot
*** SUMMARY ***
Total pot $4 | Rake $0 
Seat 1: fightingnuns (button) (small blind) folded before Flop
Seat 2: sp2608 (big blind) collected ($4)



PokerStars Game #59852557162:  Hold'em No Limit ($2/$4 USD) - 2011/03/26 18:09:27 ET
Table 'Tucana VI' 2-max Seat #2 is the button
Seat 1: fightingnuns ($200 in chips) 
Seat 2: sp2608 ($806.40 in chips) 
sp2608: posts small blind $2
fightingnuns: posts big blind $4
*** HOLE CARDS ***
Dealt to fightingnuns [8s 2h]
sp2608: raises $8 to $12
fightingnuns: folds 
Uncalled bet ($8) returned to sp2608
sp2608 collected $8 from pot
*** SUMMARY ***
Total pot $8 | Rake $0 
Seat 1: fightingnuns (big blind) folded before Flop
Seat 2: sp2608 (button) (small blind) collected ($8)



PokerStars Game #59852564418:  Hold'em No Limit ($2/$4 USD) - 2011/03/26 18:09:35 ET
Table 'Tucana VI' 2-max Seat #1 is the button
Seat 1: fightingnuns ($200 in chips) 
Seat 2: sp2608 ($810.40 in chips) 
fightingnuns: posts small blind $2
sp2608: posts big blind $4
*** HOLE CARDS ***
Dealt to fightingnuns [Jh 9h]
fightingnuns: raises $4 to $8
sp2608: calls $4
*** FLOP *** [4h Kd 5h]
sp2608: checks 
fightingnuns: bets $12
sp2608: calls $12
*** TURN *** [4h Kd 5h] [4s]
sp2608: checks 
fightingnuns: bets $28
sp2608: folds 
Uncalled bet ($28) returned to fightingnuns
fightingnuns collected $39.50 from pot
fightingnuns: doesn't show hand 
*** SUMMARY ***
Total pot $40 | Rake $0.50 
Board [4h Kd 5h 4s]
Seat 1: fightingnuns (button) (small blind) collected ($39.50)
Seat 2: sp2608 (big blind) folded on the Turn



PokerStars Game #59852587087:  Hold'em No Limit ($2/$4 USD) - 2011/03/26 18:09:58 ET
Table 'Tucana VI' 2-max Seat #2 is the button
Seat 1: fightingnuns ($219.50 in chips) 
Seat 2: sp2608 ($790.40 in chips) 
sp2608: posts small blind $2
fightingnuns: posts big blind $4
*** HOLE CARDS ***
Dealt to fightingnuns [6s 7d]
sp2608: calls $2
fightingnuns: checks 
*** FLOP *** [6c 5d 5s]
fightingnuns: bets $8
sp2608: calls $8
*** TURN *** [6c 5d 5s] [8s]
fightingnuns: checks 
sp2608: checks 
*** RIVER *** [6c 5d 5s 8s] [8h]
fightingnuns: checks 
sp2608: bets $24
fightingnuns: calls $24
*** SHOW DOWN ***
sp2608: shows [9s 4s] (two pair, Eights and Fives)
fightingnuns: shows [6s 7d] (two pair, Eights and Sixes)
fightingnuns collected $71.50 from pot
*** SUMMARY ***
Total pot $72 | Rake $0.50 
Board [6c 5d 5s 8s 8h]
Seat 1: fightingnuns (big blind) showed [6s 7d] and won ($71.50) with two pair, Eights and Sixes
Seat 2: sp2608 (button) (small blind) showed [9s 4s] and lost with two pair, Eights and Fives



PokerStars Game #59852614247:  Hold'em No Limit ($2/$4 USD) - 2011/03/26 18:10:27 ET
Table 'Tucana VI' 2-max Seat #1 is the button
Seat 1: fightingnuns ($255 in chips) 
Seat 2: sp2608 ($754.40 in chips) 
fightingnuns: posts small blind $2
sp2608: posts big blind $4
*** HOLE CARDS ***
Dealt to fightingnuns [6s 4s]
fightingnuns: raises $4 to $8
sp2608: calls $4
*** FLOP *** [4h As 9d]
sp2608: checks 
fightingnuns: checks 
*** TURN *** [4h As 9d] [8d]
sp2608: checks 
fightingnuns: checks 
*** RIVER *** [4h As 9d 8d] [5d]
sp2608: checks 
fightingnuns: checks 
*** SHOW DOWN ***
sp2608: shows [Qs 7d] (high card Ace)
fightingnuns: shows [6s 4s] (a pair of Fours)
fightingnuns collected $15.50 from pot
*** SUMMARY ***
Total pot $16 | Rake $0.50 
Board [4h As 9d 8d 5d]
Seat 1: fightingnuns (button) (small blind) showed [6s 4s] and won ($15.50) with a pair of Fours
Seat 2: sp2608 (big blind) showed [Qs 7d] and lost with high card Ace



PokerStars Game #59852639711:  Hold'em No Limit ($2/$4 USD) - 2011/03/26 18:10:54 ET
Table 'Tucana VI' 2-max Seat #2 is the button
Seat 1: fightingnuns ($262.50 in chips) 
Seat 2: sp2608 ($746.40 in chips) 
sp2608: posts small blind $2
fightingnuns: posts big blind $4
*** HOLE CARDS ***
Dealt to fightingnuns [4d 4c]
sp2608: folds 
Uncalled bet ($2) returned to fightingnuns
fightingnuns collected $4 from pot
fightingnuns: doesn't show hand 
*** SUMMARY ***
Total pot $4 | Rake $0 
Seat 1: fightingnuns (big blind) collected ($4)
Seat 2: sp2608 (button) (small blind) folded before Flop



PokerStars Game #59852646207:  Hold'em No Limit ($2/$4 USD) - 2011/03/26 18:11:01 ET
Table 'Tucana VI' 2-max Seat #1 is the button
Seat 1: fightingnuns ($264.50 in chips) 
Seat 2: sp2608 ($744.40 in chips) 
fightingnuns: posts small blind $2
sp2608: posts big blind $4
*** HOLE CARDS ***
Dealt to fightingnuns [Jh Ts]
fightingnuns: raises $4 to $8
sp2608: raises $8 to $16
fightingnuns: calls $8
*** FLOP *** [7s 5c Th]
sp2608: checks 
fightingnuns: checks 
*** TURN *** [7s 5c Th] [8h]
sp2608: bets $12
fightingnuns: calls $12
*** RIVER *** [7s 5c Th 8h] [5d]
sp2608: checks 
fightingnuns: bets $36
sp2608: raises $152 to $188
fightingnuns: calls $152
*** SHOW DOWN ***
sp2608: shows [Ac Qh] (a pair of Fives)
fightingnuns: shows [Jh Ts] (two pair, Tens and Fives)
fightingnuns collected $431.50 from pot
*** SUMMARY ***
Total pot $432 | Rake $0.50 
Board [7s 5c Th 8h 5d]
Seat 1: fightingnuns (button) (small blind) showed [Jh Ts] and won ($431.50) with two pair, Tens and Fives
Seat 2: sp2608 (big blind) showed [Ac Qh] and lost with a pair of Fives



PokerStars Game #59852696250:  Hold'em No Limit ($2/$4 USD) - 2011/03/26 18:11:53 ET
Table 'Tucana VI' 2-max Seat #2 is the button
Seat 1: fightingnuns ($480 in chips) 
Seat 2: sp2608 ($528.40 in chips) 
sp2608: posts small blind $2
fightingnuns: posts big blind $4
*** HOLE CARDS ***
Dealt to fightingnuns [Qs Tc]
sp2608: raises $4 to $8
fightingnuns: calls $4
*** FLOP *** [5d Qd 2c]
fightingnuns: checks 
sp2608: bets $16
fightingnuns: calls $16
*** TURN *** [5d Qd 2c] [6s]
fightingnuns: checks 
sp2608: bets $24
fightingnuns: calls $24
*** RIVER *** [5d Qd 2c 6s] [7c]
fightingnuns: checks 
sp2608: checks 
*** SHOW DOWN ***
fightingnuns: shows [Qs Tc] (a pair of Queens)
sp2608: mucks hand 
fightingnuns collected $95.50 from pot
*** SUMMARY ***
Total pot $96 | Rake $0.50 
Board [5d Qd 2c 6s 7c]
Seat 1: fightingnuns (big blind) showed [Qs Tc] and won ($95.50) with a pair of Queens
Seat 2: sp2608 (button) (small blind) mucked [4d Ad]



PokerStars Game #59852732913:  Hold'em No Limit ($2/$4 USD) - 2011/03/26 18:12:32 ET
Table 'Tucana VI' 2-max Seat #1 is the button
Seat 1: fightingnuns ($527.50 in chips) 
Seat 2: sp2608 ($480.40 in chips) 
fightingnuns: posts small blind $2
sp2608: posts big blind $4
*** HOLE CARDS ***
Dealt to fightingnuns [Qh 2h]
fightingnuns: raises $4 to $8
sp2608: calls $4
*** FLOP *** [5d 9s Jc]
sp2608: bets $20
fightingnuns: folds 
Uncalled bet ($20) returned to sp2608
sp2608 collected $15.50 from pot
*** SUMMARY ***
Total pot $16 | Rake $0.50 
Board [5d 9s Jc]
Seat 1: fightingnuns (button) (small blind) folded on the Flop
Seat 2: sp2608 (big blind) collected ($15.50)



PokerStars Game #59852750448:  Hold'em No Limit ($2/$4 USD) - 2011/03/26 18:12:51 ET
Table 'Tucana VI' 2-max Seat #2 is the button
Seat 1: fightingnuns ($519.50 in chips) 
Seat 2: sp2608 ($487.90 in chips) 
sp2608: posts small blind $2
fightingnuns: posts big blind $4
*** HOLE CARDS ***
Dealt to fightingnuns [Qc 7c]
sp2608: calls $2
fightingnuns: checks 
*** FLOP *** [4c Ad As]
fightingnuns: checks 
sp2608: checks 
*** TURN *** [4c Ad As] [6h]
fightingnuns: checks 
sp2608: checks 
*** RIVER *** [4c Ad As 6h] [2d]
fightingnuns: checks 
sp2608: checks 
*** SHOW DOWN ***
fightingnuns: shows [Qc 7c] (a pair of Aces)
sp2608: mucks hand 
fightingnuns collected $7.60 from pot
*** SUMMARY ***
Total pot $8 | Rake $0.40 
Board [4c Ad As 6h 2d]
Seat 1: fightingnuns (big blind) showed [Qc 7c] and won ($7.60) with a pair of Aces
Seat 2: sp2608 (button) (small blind) mucked [3h Qd]



PokerStars Game #59852782586:  Hold'em No Limit ($2/$4 USD) - 2011/03/26 18:13:24 ET
Table 'Tucana VI' 2-max Seat #1 is the button
Seat 1: fightingnuns ($523.10 in chips) 
Seat 2: sp2608 ($483.90 in chips) 
fightingnuns: posts small blind $2
sp2608: posts big blind $4
*** HOLE CARDS ***
Dealt to fightingnuns [2d 8s]
fightingnuns: folds 
Uncalled bet ($2) returned to sp2608
sp2608 collected $4 from pot
*** SUMMARY ***
Total pot $4 | Rake $0 
Seat 1: fightingnuns (button) (small blind) folded before Flop
Seat 2: sp2608 (big blind) collected ($4)



PokerStars Game #59852789117:  Hold'em No Limit ($2/$4 USD) - 2011/03/26 18:13:31 ET
Table 'Tucana VI' 2-max Seat #2 is the button
Seat 1: fightingnuns ($521.10 in chips) 
Seat 2: sp2608 ($485.90 in chips) 
sp2608: posts small blind $2
fightingnuns: posts big blind $4
*** HOLE CARDS ***
Dealt to fightingnuns [7d 4c]
sp2608: raises $12 to $16
fightingnuns: folds 
Uncalled bet ($12) returned to sp2608
sp2608 collected $8 from pot
*** SUMMARY ***
Total pot $8 | Rake $0 
Seat 1: fightingnuns (big blind) folded before Flop
Seat 2: sp2608 (button) (small blind) collected ($8)



PokerStars Game #59852797306:  Hold'em No Limit ($2/$4 USD) - 2011/03/26 18:13:40 ET
Table 'Tucana VI' 2-max Seat #1 is the button
Seat 1: fightingnuns ($517.10 in chips) 
Seat 2: sp2608 ($489.90 in chips) 
fightingnuns: posts small blind $2
sp2608: posts big blind $4
*** HOLE CARDS ***
Dealt to fightingnuns [Tc 3d]
fightingnuns: folds 
Uncalled bet ($2) returned to sp2608
sp2608 collected $4 from pot
*** SUMMARY ***
Total pot $4 | Rake $0 
Seat 1: fightingnuns (button) (small blind) folded before Flop
Seat 2: sp2608 (big blind) collected ($4)



PokerStars Game #59852803464:  Hold'em No Limit ($2/$4 USD) - 2011/03/26 18:13:47 ET
Table 'Tucana VI' 2-max Seat #2 is the button
Seat 1: fightingnuns ($515.10 in chips) 
Seat 2: sp2608 ($491.90 in chips) 
sp2608: posts small blind $2
fightingnuns: posts big blind $4
*** HOLE CARDS ***
Dealt to fightingnuns [Tc 8s]
sp2608: calls $2
fightingnuns: checks 
*** FLOP *** [9s 4h 4d]
fightingnuns: checks 
sp2608: checks 
*** TURN *** [9s 4h 4d] [Kc]
fightingnuns: checks 
sp2608: bets $8
fightingnuns: folds 
Uncalled bet ($8) returned to sp2608
sp2608 collected $7.60 from pot
*** SUMMARY ***
Total pot $8 | Rake $0.40 
Board [9s 4h 4d Kc]
Seat 1: fightingnuns (big blind) folded on the Turn
Seat 2: sp2608 (button) (small blind) collected ($7.60)



PokerStars Game #59852824105:  Hold'em No Limit ($2/$4 USD) - 2011/03/26 18:14:09 ET
Table 'Tucana VI' 2-max Seat #1 is the button
Seat 1: fightingnuns ($511.10 in chips) 
Seat 2: sp2608 ($495.50 in chips) 
fightingnuns: posts small blind $2
sp2608: posts big blind $4
*** HOLE CARDS ***
Dealt to fightingnuns [4h 9s]
fightingnuns: folds 
Uncalled bet ($2) returned to sp2608
sp2608 collected $4 from pot
*** SUMMARY ***
Total pot $4 | Rake $0 
Seat 1: fightingnuns (button) (small blind) folded before Flop
Seat 2: sp2608 (big blind) collected ($4)



PokerStars Game #59853395802:  Hold'em No Limit ($2/$4 USD) - 2011/03/26 18:24:22 ET
Table 'Tucana VI' 2-max Seat #2 is the button
Seat 1: fightingnuns ($509.10 in chips) 
Seat 2: Enri7 ($80.90 in chips) 
Enri7: posts small blind $2
fightingnuns: posts big blind $4
*** HOLE CARDS ***
Dealt to fightingnuns [Kc 6d]
Enri7: raises $4 to $8
fightingnuns: folds 
Uncalled bet ($4) returned to Enri7
Enri7 collected $8 from pot
*** SUMMARY ***
Total pot $8 | Rake $0 
Seat 1: fightingnuns (big blind) folded before Flop
Seat 2: Enri7 (button) (small blind) collected ($8)



PokerStars Game #59776851471:  Hold'em No Limit ($2/$4 USD) - 2011/03/25 12:26:30 ET
Table 'Ambrosia X' 2-max Seat #2 is the button
Seat 1: fightingnuns ($200 in chips) 
Seat 2: donkdonk606 ($200 in chips) 
donkdonk606: posts small blind $2
fightingnuns: posts big blind $4
*** HOLE CARDS ***
Dealt to fightingnuns [Td 8d]
donkdonk606: raises $4 to $8
fightingnuns: folds 
Uncalled bet ($4) returned to donkdonk606
donkdonk606 collected $8 from pot
donkdonk606: doesn't show hand 
*** SUMMARY ***
Total pot $8 | Rake $0 
Seat 1: fightingnuns (big blind) folded before Flop
Seat 2: donkdonk606 (button) (small blind) collected ($8)



PokerStars Game #59776864416:  Hold'em No Limit ($2/$4 USD) - 2011/03/25 12:26:47 ET
Table 'Ambrosia X' 2-max Seat #1 is the button
Seat 1: fightingnuns ($200 in chips) 
Seat 2: donkdonk606 ($204 in chips) 
fightingnuns: posts small blind $2
donkdonk606: posts big blind $4
*** HOLE CARDS ***
Dealt to fightingnuns [Qh 3s]
fightingnuns: raises $4 to $8
donkdonk606: folds 
Uncalled bet ($4) returned to fightingnuns
fightingnuns collected $8 from pot
fightingnuns: doesn't show hand 
*** SUMMARY ***
Total pot $8 | Rake $0 
Seat 1: fightingnuns (button) (small blind) collected ($8)
Seat 2: donkdonk606 (big blind) folded before Flop



PokerStars Game #59776871776:  Hold'em No Limit ($2/$4 USD) - 2011/03/25 12:26:57 ET
Table 'Ambrosia X' 2-max Seat #2 is the button
Seat 1: fightingnuns ($204 in chips) 
Seat 2: donkdonk606 ($200 in chips) 
donkdonk606: posts small blind $2
fightingnuns: posts big blind $4
*** HOLE CARDS ***
Dealt to fightingnuns [5c Tc]
donkdonk606: folds 
Uncalled bet ($2) returned to fightingnuns
fightingnuns collected $4 from pot
fightingnuns: doesn't show hand 
*** SUMMARY ***
Total pot $4 | Rake $0 
Seat 1: fightingnuns (big blind) collected ($4)
Seat 2: donkdonk606 (button) (small blind) folded before Flop



PokerStars Game #59776875930:  Hold'em No Limit ($2/$4 USD) - 2011/03/25 12:27:02 ET
Table 'Ambrosia X' 2-max Seat #1 is the button
Seat 1: fightingnuns ($206 in chips) 
Seat 2: donkdonk606 ($198 in chips) 
fightingnuns: posts small blind $2
donkdonk606: posts big blind $4
*** HOLE CARDS ***
Dealt to fightingnuns [Ks 3s]
fightingnuns: raises $4 to $8
donkdonk606: calls $4
*** FLOP *** [5d 7s Ah]
donkdonk606: checks 
fightingnuns: checks 
*** TURN *** [5d 7s Ah] [Qh]
donkdonk606: bets $12
fightingnuns: folds 
Uncalled bet ($12) returned to donkdonk606
donkdonk606 collected $15.50 from pot
donkdonk606: doesn't show hand 
*** SUMMARY ***
Total pot $16 | Rake $0.50 
Board [5d 7s Ah Qh]
Seat 1: fightingnuns (button) (small blind) folded on the Turn
Seat 2: donkdonk606 (big blind) collected ($15.50)



PokerStars Game #59776895040:  Hold'em No Limit ($2/$4 USD) - 2011/03/25 12:27:28 ET
Table 'Ambrosia X' 2-max Seat #2 is the button
Seat 1: fightingnuns ($200 in chips) 
Seat 2: donkdonk606 ($205.50 in chips) 
donkdonk606: posts small blind $2
fightingnuns: posts big blind $4
*** HOLE CARDS ***
Dealt to fightingnuns [Jc 7s]
donkdonk606: folds 
Uncalled bet ($2) returned to fightingnuns
fightingnuns collected $4 from pot
fightingnuns: doesn't show hand 
*** SUMMARY ***
Total pot $4 | Rake $0 
Seat 1: fightingnuns (big blind) collected ($4)
Seat 2: donkdonk606 (button) (small blind) folded before Flop



PokerStars Game #59776899084:  Hold'em No Limit ($2/$4 USD) - 2011/03/25 12:27:33 ET
Table 'Ambrosia X' 2-max Seat #1 is the button
Seat 1: fightingnuns ($202 in chips) 
Seat 2: donkdonk606 ($203.50 in chips) 
fightingnuns: posts small blind $2
donkdonk606: posts big blind $4
*** HOLE CARDS ***
Dealt to fightingnuns [Ts Jc]
fightingnuns: raises $4 to $8
donkdonk606: folds 
Uncalled bet ($4) returned to fightingnuns
fightingnuns collected $8 from pot
fightingnuns: doesn't show hand 
*** SUMMARY ***
Total pot $8 | Rake $0 
Seat 1: fightingnuns (button) (small blind) collected ($8)
Seat 2: donkdonk606 (big blind) folded before Flop



PokerStars Game #59776905736:  Hold'em No Limit ($2/$4 USD) - 2011/03/25 12:27:42 ET
Table 'Ambrosia X' 2-max Seat #2 is the button
Seat 1: fightingnuns ($206 in chips) 
Seat 2: donkdonk606 ($199.50 in chips) 
donkdonk606: posts small blind $2
fightingnuns: posts big blind $4
*** HOLE CARDS ***
Dealt to fightingnuns [5c Kc]
donkdonk606: folds 
Uncalled bet ($2) returned to fightingnuns
fightingnuns collected $4 from pot
fightingnuns: doesn't show hand 
*** SUMMARY ***
Total pot $4 | Rake $0 
Seat 1: fightingnuns (big blind) collected ($4)
Seat 2: donkdonk606 (button) (small blind) folded before Flop



PokerStars Game #59776909610:  Hold'em No Limit ($2/$4 USD) - 2011/03/25 12:27:47 ET
Table 'Ambrosia X' 2-max Seat #1 is the button
Seat 1: fightingnuns ($208 in chips) 
Seat 2: donkdonk606 ($197.50 in chips) 
fightingnuns: posts small blind $2
donkdonk606: posts big blind $4
*** HOLE CARDS ***
Dealt to fightingnuns [Qs 7d]
fightingnuns: raises $4 to $8
donkdonk606: raises $8 to $16
fightingnuns: calls $8
*** FLOP *** [3c 5c 9d]
donkdonk606: bets $32
fightingnuns: folds 
Uncalled bet ($32) returned to donkdonk606
donkdonk606 collected $31.50 from pot
donkdonk606: doesn't show hand 
*** SUMMARY ***
Total pot $32 | Rake $0.50 
Board [3c 5c 9d]
Seat 1: fightingnuns (button) (small blind) folded on the Flop
Seat 2: donkdonk606 (big blind) collected ($31.50)



PokerStars Game #59776927552:  Hold'em No Limit ($2/$4 USD) - 2011/03/25 12:28:11 ET
Table 'Ambrosia X' 2-max Seat #2 is the button
Seat 1: fightingnuns ($200 in chips) 
Seat 2: donkdonk606 ($213 in chips) 
donkdonk606: posts small blind $2
fightingnuns: posts big blind $4
*** HOLE CARDS ***
Dealt to fightingnuns [7c Ah]
donkdonk606: calls $2
fightingnuns: raises $12 to $16
donkdonk606: folds 
Uncalled bet ($12) returned to fightingnuns
fightingnuns collected $8 from pot
fightingnuns: doesn't show hand 
*** SUMMARY ***
Total pot $8 | Rake $0 
Seat 1: fightingnuns (big blind) collected ($8)
Seat 2: donkdonk606 (button) (small blind) folded before Flop



PokerStars Game #59776935618:  Hold'em No Limit ($2/$4 USD) - 2011/03/25 12:28:22 ET
Table 'Ambrosia X' 2-max Seat #1 is the button
Seat 1: fightingnuns ($204 in chips) 
Seat 2: donkdonk606 ($209 in chips) 
fightingnuns: posts small blind $2
donkdonk606: posts big blind $4
*** HOLE CARDS ***
Dealt to fightingnuns [4c Tc]
fightingnuns: raises $4 to $8
donkdonk606: calls $4
*** FLOP *** [9c 8d 7h]
donkdonk606: checks 
fightingnuns: bets $12
donkdonk606: folds 
Uncalled bet ($12) returned to fightingnuns
fightingnuns collected $15.50 from pot
fightingnuns: doesn't show hand 
*** SUMMARY ***
Total pot $16 | Rake $0.50 
Board [9c 8d 7h]
Seat 1: fightingnuns (button) (small blind) collected ($15.50)
Seat 2: donkdonk606 (big blind) folded on the Flop



PokerStars Game #59776949227:  Hold'em No Limit ($2/$4 USD) - 2011/03/25 12:28:40 ET
Table 'Ambrosia X' 2-max Seat #2 is the button
Seat 1: fightingnuns ($211.50 in chips) 
Seat 2: donkdonk606 ($201 in chips) 
donkdonk606: posts small blind $2
fightingnuns: posts big blind $4
*** HOLE CARDS ***
Dealt to fightingnuns [Jd Ad]
donkdonk606: raises $4 to $8
fightingnuns: raises $16 to $24
donkdonk606: calls $16
*** FLOP *** [9s Kh Ac]
fightingnuns: bets $32
donkdonk606: raises $145 to $177 and is all-in
fightingnuns: calls $145
*** TURN *** [9s Kh Ac] [4d]
*** RIVER *** [9s Kh Ac 4d] [2h]
*** SHOW DOWN ***
fightingnuns: shows [Jd Ad] (a pair of Aces)
donkdonk606: shows [Ah Qs] (a pair of Aces - King+Queen kicker)
donkdonk606 collected $401.50 from pot
*** SUMMARY ***
Total pot $402 | Rake $0.50 
Board [9s Kh Ac 4d 2h]
Seat 1: fightingnuns (big blind) showed [Jd Ad] and lost with a pair of Aces
Seat 2: donkdonk606 (button) (small blind) showed [Ah Qs] and won ($401.50) with a pair of Aces



PokerStars Game #59776976864:  Hold'em No Limit ($2/$4 USD) - 2011/03/25 12:29:17 ET
Table 'Ambrosia X' 2-max Seat #1 is the button
Seat 1: fightingnuns ($200 in chips) 
Seat 2: donkdonk606 ($401.50 in chips) 
fightingnuns: posts small blind $2
donkdonk606: posts big blind $4
*** HOLE CARDS ***
Dealt to fightingnuns [Qh 9h]
fightingnuns: raises $8 to $12
donkdonk606: folds 
Uncalled bet ($8) returned to fightingnuns
fightingnuns collected $8 from pot
fightingnuns: doesn't show hand 
*** SUMMARY ***
Total pot $8 | Rake $0 
Seat 1: fightingnuns (button) (small blind) collected ($8)
Seat 2: donkdonk606 (big blind) folded before Flop



PokerStars Game #59776983470:  Hold'em No Limit ($2/$4 USD) - 2011/03/25 12:29:26 ET
Table 'Ambrosia X' 2-max Seat #2 is the button
Seat 1: fightingnuns ($204 in chips) 
Seat 2: donkdonk606 ($397.50 in chips) 
donkdonk606: posts small blind $2
fightingnuns: posts big blind $4
*** HOLE CARDS ***
Dealt to fightingnuns [9d 3s]
donkdonk606: calls $2
fightingnuns: checks 
*** FLOP *** [Ac Th 8d]
fightingnuns: checks 
donkdonk606: checks 
*** TURN *** [Ac Th 8d] [4d]
fightingnuns: checks 
donkdonk606: checks 
*** RIVER *** [Ac Th 8d 4d] [Ts]
fightingnuns: checks 
donkdonk606: checks 
*** SHOW DOWN ***
fightingnuns: shows [9d 3s] (a pair of Tens)
donkdonk606: shows [Ks 5s] (a pair of Tens - Ace+King kicker)
donkdonk606 collected $7.60 from pot
*** SUMMARY ***
Total pot $8 | Rake $0.40 
Board [Ac Th 8d 4d Ts]
Seat 1: fightingnuns (big blind) showed [9d 3s] and lost with a pair of Tens
Seat 2: donkdonk606 (button) (small blind) showed [Ks 5s] and won ($7.60) with a pair of Tens



PokerStars Game #59777005083:  Hold'em No Limit ($2/$4 USD) - 2011/03/25 12:29:55 ET
Table 'Ambrosia X' 2-max Seat #1 is the button
Seat 1: fightingnuns ($200 in chips) 
Seat 2: donkdonk606 ($401.10 in chips) 
fightingnuns: posts small blind $2
donkdonk606: posts big blind $4
*** HOLE CARDS ***
Dealt to fightingnuns [Ad Qh]
fightingnuns: raises $8 to $12
donkdonk606: folds 
Uncalled bet ($8) returned to fightingnuns
fightingnuns collected $8 from pot
fightingnuns: doesn't show hand 
*** SUMMARY ***
Total pot $8 | Rake $0 
Seat 1: fightingnuns (button) (small blind) collected ($8)
Seat 2: donkdonk606 (big blind) folded before Flop



PokerStars Game #59777019724:  Hold'em No Limit ($2/$4 USD) - 2011/03/25 12:30:14 ET
Table 'Ambrosia X' 2-max Seat #2 is the button
Seat 1: fightingnuns ($204 in chips) 
Seat 2: donkdonk606 ($397.10 in chips) 
donkdonk606: posts small blind $2
fightingnuns: posts big blind $4
*** HOLE CARDS ***
Dealt to fightingnuns [2h 4s]
donkdonk606: folds 
Uncalled bet ($2) returned to fightingnuns
fightingnuns collected $4 from pot
fightingnuns: doesn't show hand 
*** SUMMARY ***
Total pot $4 | Rake $0 
Seat 1: fightingnuns (big blind) collected ($4)
Seat 2: donkdonk606 (button) (small blind) folded before Flop



PokerStars Game #59777023885:  Hold'em No Limit ($2/$4 USD) - 2011/03/25 12:30:20 ET
Table 'Ambrosia X' 2-max Seat #1 is the button
Seat 1: fightingnuns ($206 in chips) 
Seat 2: donkdonk606 ($395.10 in chips) 
fightingnuns: posts small blind $2
donkdonk606: posts big blind $4
*** HOLE CARDS ***
Dealt to fightingnuns [2s 7s]
fightingnuns: raises $8 to $12
donkdonk606: folds 
Uncalled bet ($8) returned to fightingnuns
fightingnuns collected $8 from pot
fightingnuns: doesn't show hand 
*** SUMMARY ***
Total pot $8 | Rake $0 
Seat 1: fightingnuns (button) (small blind) collected ($8)
Seat 2: donkdonk606 (big blind) folded before Flop



PokerStars Game #59777030571:  Hold'em No Limit ($2/$4 USD) - 2011/03/25 12:30:29 ET
Table 'Ambrosia X' 2-max Seat #2 is the button
Seat 1: fightingnuns ($210 in chips) 
Seat 2: donkdonk606 ($391.10 in chips) 
donkdonk606: posts small blind $2
fightingnuns: posts big blind $4
*** HOLE CARDS ***
Dealt to fightingnuns [Ks 4d]
donkdonk606: raises $4 to $8
fightingnuns: folds 
Uncalled bet ($4) returned to donkdonk606
donkdonk606 collected $8 from pot
donkdonk606: doesn't show hand 
*** SUMMARY ***
Total pot $8 | Rake $0 
Seat 1: fightingnuns (big blind) folded before Flop
Seat 2: donkdonk606 (button) (small blind) collected ($8)



PokerStars Game #59777040252:  Hold'em No Limit ($2/$4 USD) - 2011/03/25 12:30:41 ET
Table 'Ambrosia X' 2-max Seat #1 is the button
Seat 1: fightingnuns ($206 in chips) 
Seat 2: donkdonk606 ($395.10 in chips) 
fightingnuns: posts small blind $2
donkdonk606: posts big blind $4
*** HOLE CARDS ***
Dealt to fightingnuns [7c 9s]
fightingnuns: raises $8 to $12
donkdonk606: calls $8
*** FLOP *** [9d 4h 6h]
donkdonk606: checks 
fightingnuns: bets $16
donkdonk606: calls $16
*** TURN *** [9d 4h 6h] [8d]
donkdonk606: checks 
fightingnuns: checks 
*** RIVER *** [9d 4h 6h 8d] [Jd]
donkdonk606: bets $40
fightingnuns: calls $40
*** SHOW DOWN ***
donkdonk606: shows [Qh 3h] (high card Queen)
fightingnuns: shows [7c 9s] (a pair of Nines)
fightingnuns collected $135.50 from pot
*** SUMMARY ***
Total pot $136 | Rake $0.50 
Board [9d 4h 6h 8d Jd]
Seat 1: fightingnuns (button) (small blind) showed [7c 9s] and won ($135.50) with a pair of Nines
Seat 2: donkdonk606 (big blind) showed [Qh 3h] and lost with high card Queen



PokerStars Game #59777072612:  Hold'em No Limit ($2/$4 USD) - 2011/03/25 12:31:25 ET
Table 'Ambrosia X' 2-max Seat #2 is the button
Seat 1: fightingnuns ($273.50 in chips) 
Seat 2: donkdonk606 ($327.10 in chips) 
donkdonk606: posts small blind $2
fightingnuns: posts big blind $4
*** HOLE CARDS ***
Dealt to fightingnuns [7h 7s]
donkdonk606: raises $8 to $12
fightingnuns: calls $8
*** FLOP *** [2c Ad Jh]
fightingnuns: checks 
donkdonk606: bets $8
fightingnuns: calls $8
*** TURN *** [2c Ad Jh] [7c]
fightingnuns: checks 
donkdonk606: bets $40
fightingnuns: raises $64 to $104
donkdonk606: raises $64 to $168
fightingnuns: raises $85.50 to $253.50 and is all-in
donkdonk606: calls $85.50
*** RIVER *** [2c Ad Jh 7c] [3c]
*** SHOW DOWN ***
fightingnuns: shows [7h 7s] (three of a kind, Sevens)
donkdonk606: shows [Ac Ah] (three of a kind, Aces)
donkdonk606 collected $546.50 from pot
*** SUMMARY ***
Total pot $547 | Rake $0.50 
Board [2c Ad Jh 7c 3c]
Seat 1: fightingnuns (big blind) showed [7h 7s] and lost with three of a kind, Sevens
Seat 2: donkdonk606 (button) (small blind) showed [Ac Ah] and won ($546.50) with three of a kind, Aces



PokerStars Game #59777108940:  Hold'em No Limit ($2/$4 USD) - 2011/03/25 12:32:12 ET
Table 'Ambrosia X' 2-max Seat #1 is the button
Seat 1: fightingnuns ($50.65 in chips) 
Seat 2: donkdonk606 ($600.10 in chips) 
fightingnuns: posts small blind $2
donkdonk606: posts big blind $4
*** HOLE CARDS ***
Dealt to fightingnuns [4c 9d]
fightingnuns: folds 
Uncalled bet ($2) returned to donkdonk606
donkdonk606 collected $4 from pot
donkdonk606: doesn't show hand 
*** SUMMARY ***
Total pot $4 | Rake $0 
Seat 1: fightingnuns (button) (small blind) folded before Flop
Seat 2: donkdonk606 (big blind) collected ($4)



PokerStars Game #59777113372:  Hold'em No Limit ($2/$4 USD) - 2011/03/25 12:32:18 ET
Table 'Ambrosia X' 2-max Seat #2 is the button
Seat 1: fightingnuns ($48.65 in chips) 
Seat 2: donkdonk606 ($602.10 in chips) 
donkdonk606: posts small blind $2
fightingnuns: posts big blind $4
*** HOLE CARDS ***
Dealt to fightingnuns [6h 4d]
donkdonk606: folds 
Uncalled bet ($2) returned to fightingnuns
fightingnuns collected $4 from pot
fightingnuns: doesn't show hand 
*** SUMMARY ***
Total pot $4 | Rake $0 
Seat 1: fightingnuns (big blind) collected ($4)
Seat 2: donkdonk606 (button) (small blind) folded before Flop



PokerStars Game #59777120629:  Hold'em No Limit ($2/$4 USD) - 2011/03/25 12:32:28 ET
Table 'Ambrosia X' 2-max Seat #1 is the button
Seat 1: fightingnuns ($50.65 in chips) 
Seat 2: donkdonk606 ($600.10 in chips) 
fightingnuns: posts small blind $2
donkdonk606: posts big blind $4
*** HOLE CARDS ***
Dealt to fightingnuns [Qc 7c]
fightingnuns: calls $2
donkdonk606: checks 
*** FLOP *** [4s 5d Jc]
donkdonk606: checks 
fightingnuns: bets $4
donkdonk606: folds 
Uncalled bet ($4) returned to fightingnuns
fightingnuns collected $7.60 from pot
fightingnuns: doesn't show hand 
*** SUMMARY ***
Total pot $8 | Rake $0.40 
Board [4s 5d Jc]
Seat 1: fightingnuns (button) (small blind) collected ($7.60)
Seat 2: donkdonk606 (big blind) folded on the Flop



PokerStars Game #59777135138:  Hold'em No Limit ($2/$4 USD) - 2011/03/25 12:32:47 ET
Table 'Ambrosia X' 2-max Seat #2 is the button
Seat 1: fightingnuns ($54.25 in chips) 
Seat 2: donkdonk606 ($596.10 in chips) 
donkdonk606: posts small blind $2
fightingnuns: posts big blind $4
*** HOLE CARDS ***
Dealt to fightingnuns [Ts Qh]
donkdonk606: calls $2
fightingnuns: checks 
*** FLOP *** [Kd 5s 8s]
fightingnuns: checks 
donkdonk606: bets $4
fightingnuns: folds 
Uncalled bet ($4) returned to donkdonk606
donkdonk606 collected $7.60 from pot
donkdonk606: doesn't show hand 
*** SUMMARY ***
Total pot $8 | Rake $0.40 
Board [Kd 5s 8s]
Seat 1: fightingnuns (big blind) folded on the Flop
Seat 2: donkdonk606 (button) (small blind) collected ($7.60)



PokerStars Game #59777150310:  Hold'em No Limit ($2/$4 USD) - 2011/03/25 12:33:07 ET
Table 'Ambrosia X' 2-max Seat #1 is the button
Seat 1: fightingnuns ($200 in chips) 
Seat 2: donkdonk606 ($599.70 in chips) 
fightingnuns: posts small blind $2
donkdonk606: posts big blind $4
*** HOLE CARDS ***
Dealt to fightingnuns [2c Jc]
fightingnuns: raises $8 to $12
donkdonk606: folds 
Uncalled bet ($8) returned to fightingnuns
fightingnuns collected $8 from pot
fightingnuns: doesn't show hand 
*** SUMMARY ***
Total pot $8 | Rake $0 
Seat 1: fightingnuns (button) (small blind) collected ($8)
Seat 2: donkdonk606 (big blind) folded before Flop



PokerStars Game #59777163478:  Hold'em No Limit ($2/$4 USD) - 2011/03/25 12:33:24 ET
Table 'Ambrosia X' 2-max Seat #2 is the button
Seat 1: fightingnuns ($204 in chips) 
Seat 2: donkdonk606 ($595.70 in chips) 
donkdonk606: posts small blind $2
fightingnuns: posts big blind $4
*** HOLE CARDS ***
Dealt to fightingnuns [Tc As]
donkdonk606: folds 
Uncalled bet ($2) returned to fightingnuns
fightingnuns collected $4 from pot
fightingnuns: doesn't show hand 
*** SUMMARY ***
Total pot $4 | Rake $0 
Seat 1: fightingnuns (big blind) collected ($4)
Seat 2: donkdonk606 (button) (small blind) folded before Flop



PokerStars Game #59777171410:  Hold'em No Limit ($2/$4 USD) - 2011/03/25 12:33:34 ET
Table 'Ambrosia X' 2-max Seat #1 is the button
Seat 1: fightingnuns ($206 in chips) 
Seat 2: donkdonk606 ($593.70 in chips) 
fightingnuns: posts small blind $2
donkdonk606: posts big blind $4
*** HOLE CARDS ***
Dealt to fightingnuns [3c 7h]
fightingnuns: folds 
Uncalled bet ($2) returned to donkdonk606
donkdonk606 collected $4 from pot
donkdonk606: doesn't show hand 
*** SUMMARY ***
Total pot $4 | Rake $0 
Seat 1: fightingnuns (button) (small blind) folded before Flop
Seat 2: donkdonk606 (big blind) collected ($4)



PokerStars Game #59777175771:  Hold'em No Limit ($2/$4 USD) - 2011/03/25 12:33:40 ET
Table 'Ambrosia X' 2-max Seat #2 is the button
Seat 1: fightingnuns ($204 in chips) 
Seat 2: donkdonk606 ($595.70 in chips) 
donkdonk606: posts small blind $2
fightingnuns: posts big blind $4
*** HOLE CARDS ***
Dealt to fightingnuns [3c Ah]
donkdonk606: calls $2
fightingnuns: raises $12 to $16
donkdonk606: folds 
Uncalled bet ($12) returned to fightingnuns
fightingnuns collected $8 from pot
fightingnuns: doesn't show hand 
*** SUMMARY ***
Total pot $8 | Rake $0 
Seat 1: fightingnuns (big blind) collected ($8)
Seat 2: donkdonk606 (button) (small blind) folded before Flop



PokerStars Game #59777184834:  Hold'em No Limit ($2/$4 USD) - 2011/03/25 12:33:52 ET
Table 'Ambrosia X' 2-max Seat #1 is the button
Seat 1: fightingnuns ($208 in chips) 
Seat 2: donkdonk606 ($591.70 in chips) 
fightingnuns: posts small blind $2
donkdonk606: posts big blind $4
*** HOLE CARDS ***
Dealt to fightingnuns [8d Kc]
fightingnuns: raises $8 to $12
donkdonk606: folds 
Uncalled bet ($8) returned to fightingnuns
fightingnuns collected $8 from pot
fightingnuns: doesn't show hand 
*** SUMMARY ***
Total pot $8 | Rake $0 
Seat 1: fightingnuns (button) (small blind) collected ($8)
Seat 2: donkdonk606 (big blind) folded before Flop



PokerStars Game #59777191992:  Hold'em No Limit ($2/$4 USD) - 2011/03/25 12:34:01 ET
Table 'Ambrosia X' 2-max Seat #2 is the button
Seat 1: fightingnuns ($212 in chips) 
Seat 2: donkdonk606 ($587.70 in chips) 
donkdonk606: posts small blind $2
fightingnuns: posts big blind $4
*** HOLE CARDS ***
Dealt to fightingnuns [9d Qs]
donkdonk606: folds 
Uncalled bet ($2) returned to fightingnuns
fightingnuns collected $4 from pot
fightingnuns: doesn't show hand 
*** SUMMARY ***
Total pot $4 | Rake $0 
Seat 1: fightingnuns (big blind) collected ($4)
Seat 2: donkdonk606 (button) (small blind) folded before Flop



PokerStars Game #59777204815:  Hold'em No Limit ($2/$4 USD) - 2011/03/25 12:34:18 ET
Table 'Ambrosia X' 2-max Seat #1 is the button
Seat 1: fightingnuns ($214 in chips) 
Seat 2: donkdonk606 ($585.70 in chips) 
fightingnuns: posts small blind $2
donkdonk606: posts big blind $4
*** HOLE CARDS ***
Dealt to fightingnuns [Kh Qd]
fightingnuns: raises $8 to $12
donkdonk606: folds 
Uncalled bet ($8) returned to fightingnuns
fightingnuns collected $8 from pot
fightingnuns: doesn't show hand 
*** SUMMARY ***
Total pot $8 | Rake $0 
Seat 1: fightingnuns (button) (small blind) collected ($8)
Seat 2: donkdonk606 (big blind) folded before Flop



PokerStars Game #59777213957:  Hold'em No Limit ($2/$4 USD) - 2011/03/25 12:34:30 ET
Table 'Ambrosia X' 2-max Seat #2 is the button
Seat 1: fightingnuns ($218 in chips) 
Seat 2: donkdonk606 ($581.70 in chips) 
donkdonk606: posts small blind $2
fightingnuns: posts big blind $4
*** HOLE CARDS ***
Dealt to fightingnuns [5d 3c]
donkdonk606: raises $4 to $8
fightingnuns: folds 
Uncalled bet ($4) returned to donkdonk606
donkdonk606 collected $8 from pot
*** SUMMARY ***
Total pot $8 | Rake $0 
Seat 1: fightingnuns (big blind) folded before Flop
Seat 2: donkdonk606 (button) (small blind) collected ($8)



PokerStars Game #59777221019:  Hold'em No Limit ($2/$4 USD) - 2011/03/25 12:34:40 ET
Table 'Ambrosia X' 2-max Seat #1 is the button
Seat 1: fightingnuns ($214 in chips) 
Seat 2: donkdonk606 ($585.70 in chips) 
fightingnuns: posts small blind $2
donkdonk606: posts big blind $4
*** HOLE CARDS ***
Dealt to fightingnuns [9s Qs]
fightingnuns: raises $8 to $12
donkdonk606: calls $8
*** FLOP *** [7d 6s 4d]
donkdonk606: bets $8
fightingnuns: folds 
Uncalled bet ($8) returned to donkdonk606
donkdonk606 collected $23.50 from pot
donkdonk606: doesn't show hand 
*** SUMMARY ***
Total pot $24 | Rake $0.50 
Board [7d 6s 4d]
Seat 1: fightingnuns (button) (small blind) folded on the Flop
Seat 2: donkdonk606 (big blind) collected ($23.50)



PokerStars Game #59777235532:  Hold'em No Limit ($2/$4 USD) - 2011/03/25 12:34:59 ET
Table 'Ambrosia X' 2-max Seat #2 is the button
Seat 1: fightingnuns ($202 in chips) 
Seat 2: donkdonk606 ($597.20 in chips) 
donkdonk606: posts small blind $2
fightingnuns: posts big blind $4
*** HOLE CARDS ***
Dealt to fightingnuns [2d 6c]
donkdonk606: folds 
Uncalled bet ($2) returned to fightingnuns
fightingnuns collected $4 from pot
fightingnuns: doesn't show hand 
*** SUMMARY ***
Total pot $4 | Rake $0 
Seat 1: fightingnuns (big blind) collected ($4)
Seat 2: donkdonk606 (button) (small blind) folded before Flop



PokerStars Game #59777240349:  Hold'em No Limit ($2/$4 USD) - 2011/03/25 12:35:05 ET
Table 'Ambrosia X' 2-max Seat #1 is the button
Seat 1: fightingnuns ($204 in chips) 
Seat 2: donkdonk606 ($595.20 in chips) 
fightingnuns: posts small blind $2
donkdonk606: posts big blind $4
*** HOLE CARDS ***
Dealt to fightingnuns [4h Kh]
fightingnuns: raises $8 to $12
donkdonk606: folds 
Uncalled bet ($8) returned to fightingnuns
fightingnuns collected $8 from pot
fightingnuns: doesn't show hand 
*** SUMMARY ***
Total pot $8 | Rake $0 
Seat 1: fightingnuns (button) (small blind) collected ($8)
Seat 2: donkdonk606 (big blind) folded before Flop



PokerStars Game #59777246338:  Hold'em No Limit ($2/$4 USD) - 2011/03/25 12:35:12 ET
Table 'Ambrosia X' 2-max Seat #2 is the button
Seat 1: fightingnuns ($208 in chips) 
Seat 2: donkdonk606 ($591.20 in chips) 
donkdonk606: posts small blind $2
fightingnuns: posts big blind $4
*** HOLE CARDS ***
Dealt to fightingnuns [8s 7h]
donkdonk606: folds 
Uncalled bet ($2) returned to fightingnuns
fightingnuns collected $4 from pot
fightingnuns: doesn't show hand 
*** SUMMARY ***
Total pot $4 | Rake $0 
Seat 1: fightingnuns (big blind) collected ($4)
Seat 2: donkdonk606 (button) (small blind) folded before Flop



PokerStars Game #59777251137:  Hold'em No Limit ($2/$4 USD) - 2011/03/25 12:35:19 ET
Table 'Ambrosia X' 2-max Seat #1 is the button
Seat 1: fightingnuns ($210 in chips) 
Seat 2: donkdonk606 ($589.20 in chips) 
fightingnuns: posts small blind $2
donkdonk606: posts big blind $4
*** HOLE CARDS ***
Dealt to fightingnuns [As 8c]
fightingnuns: raises $8 to $12
donkdonk606: folds 
Uncalled bet ($8) returned to fightingnuns
fightingnuns collected $8 from pot
fightingnuns: doesn't show hand 
*** SUMMARY ***
Total pot $8 | Rake $0 
Seat 1: fightingnuns (button) (small blind) collected ($8)
Seat 2: donkdonk606 (big blind) folded before Flop



PokerStars Game #59777258430:  Hold'em No Limit ($2/$4 USD) - 2011/03/25 12:35:28 ET
Table 'Ambrosia X' 2-max Seat #2 is the button
Seat 1: fightingnuns ($214 in chips) 
Seat 2: donkdonk606 ($585.20 in chips) 
donkdonk606: posts small blind $2
fightingnuns: posts big blind $4
*** HOLE CARDS ***
Dealt to fightingnuns [6h Jc]
donkdonk606: raises $4 to $8
fightingnuns: folds 
Uncalled bet ($4) returned to donkdonk606
donkdonk606 collected $8 from pot
donkdonk606: doesn't show hand 
*** SUMMARY ***
Total pot $8 | Rake $0 
Seat 1: fightingnuns (big blind) folded before Flop
Seat 2: donkdonk606 (button) (small blind) collected ($8)



PokerStars Game #59777267437:  Hold'em No Limit ($2/$4 USD) - 2011/03/25 12:35:40 ET
Table 'Ambrosia X' 2-max Seat #1 is the button
Seat 1: fightingnuns ($210 in chips) 
Seat 2: donkdonk606 ($589.20 in chips) 
fightingnuns: posts small blind $2
donkdonk606: posts big blind $4
*** HOLE CARDS ***
Dealt to fightingnuns [Jd Jh]
fightingnuns: raises $8 to $12
donkdonk606: calls $8
*** FLOP *** [Ac 5c 6d]
donkdonk606: checks 
fightingnuns: checks 
*** TURN *** [Ac 5c 6d] [Th]
donkdonk606: bets $12
fightingnuns: calls $12
*** RIVER *** [Ac 5c 6d Th] [4c]
donkdonk606: bets $12
fightingnuns: calls $12
*** SHOW DOWN ***
donkdonk606: shows [Td Kh] (a pair of Tens)
fightingnuns: shows [Jd Jh] (a pair of Jacks)
fightingnuns collected $71.50 from pot
*** SUMMARY ***
Total pot $72 | Rake $0.50 
Board [Ac 5c 6d Th 4c]
Seat 1: fightingnuns (button) (small blind) showed [Jd Jh] and won ($71.50) with a pair of Jacks
Seat 2: donkdonk606 (big blind) showed [Td Kh] and lost with a pair of Tens



PokerStars Game #59777293682:  Hold'em No Limit ($2/$4 USD) - 2011/03/25 12:36:14 ET
Table 'Ambrosia X' 2-max Seat #2 is the button
Seat 1: fightingnuns ($245.50 in chips) 
Seat 2: donkdonk606 ($553.20 in chips) 
donkdonk606: posts small blind $2
fightingnuns: posts big blind $4
*** HOLE CARDS ***
Dealt to fightingnuns [Ah Ks]
donkdonk606: folds 
Uncalled bet ($2) returned to fightingnuns
fightingnuns collected $4 from pot
fightingnuns: doesn't show hand 
*** SUMMARY ***
Total pot $4 | Rake $0 
Seat 1: fightingnuns (big blind) collected ($4)
Seat 2: donkdonk606 (button) (small blind) folded before Flop



PokerStars Game #59777298825:  Hold'em No Limit ($2/$4 USD) - 2011/03/25 12:36:21 ET
Table 'Ambrosia X' 2-max Seat #1 is the button
Seat 1: fightingnuns ($247.50 in chips) 
Seat 2: donkdonk606 ($551.20 in chips) 
fightingnuns: posts small blind $2
donkdonk606: posts big blind $4
*** HOLE CARDS ***
Dealt to fightingnuns [7h 5d]
fightingnuns: raises $8 to $12
donkdonk606: calls $8
*** FLOP *** [Qd 6s Td]
donkdonk606: checks 
fightingnuns: bets $16
donkdonk606: calls $16
*** TURN *** [Qd 6s Td] [2c]
donkdonk606: checks 
fightingnuns: checks 
*** RIVER *** [Qd 6s Td 2c] [Ah]
donkdonk606: checks 
fightingnuns: bets $40
donkdonk606: calls $40
*** SHOW DOWN ***
fightingnuns: shows [7h 5d] (high card Ace)
donkdonk606: shows [Kh Qh] (a pair of Queens)
donkdonk606 collected $135.50 from pot
*** SUMMARY ***
Total pot $136 | Rake $0.50 
Board [Qd 6s Td 2c Ah]
Seat 1: fightingnuns (button) (small blind) showed [7h 5d] and lost with high card Ace
Seat 2: donkdonk606 (big blind) showed [Kh Qh] and won ($135.50) with a pair of Queens



PokerStars Game #59777330850:  Hold'em No Limit ($2/$4 USD) - 2011/03/25 12:37:02 ET
Table 'Ambrosia X' 2-max Seat #2 is the button
Seat 1: fightingnuns ($200 in chips) 
Seat 2: donkdonk606 ($618.70 in chips) 
donkdonk606: posts small blind $2
fightingnuns: posts big blind $4
*** HOLE CARDS ***
Dealt to fightingnuns [2s Ts]
donkdonk606: calls $2
fightingnuns: checks 
*** FLOP *** [7d 9s 3h]
fightingnuns: checks 
donkdonk606: bets $4
fightingnuns: folds 
Uncalled bet ($4) returned to donkdonk606
donkdonk606 collected $7.60 from pot
*** SUMMARY ***
Total pot $8 | Rake $0.40 
Board [7d 9s 3h]
Seat 1: fightingnuns (big blind) folded on the Flop
Seat 2: donkdonk606 (button) (small blind) collected ($7.60)



PokerStars Game #59777342491:  Hold'em No Limit ($2/$4 USD) - 2011/03/25 12:37:18 ET
Table 'Ambrosia X' 2-max Seat #1 is the button
Seat 1: fightingnuns ($200 in chips) 
Seat 2: donkdonk606 ($622.30 in chips) 
fightingnuns: posts small blind $2
donkdonk606: posts big blind $4
*** HOLE CARDS ***
Dealt to fightingnuns [3c Jc]
fightingnuns: raises $8 to $12
donkdonk606: calls $8
*** FLOP *** [Kh 4c 4h]
donkdonk606: checks 
fightingnuns: bets $16
donkdonk606: calls $16
*** TURN *** [Kh 4c 4h] [4d]
donkdonk606: bets $4
fightingnuns: calls $4
*** RIVER *** [Kh 4c 4h 4d] [Kc]
donkdonk606: bets $20
fightingnuns: calls $20
*** SHOW DOWN ***
donkdonk606: shows [Ts Ks] (a full house, Kings full of Fours)
fightingnuns: mucks hand 
donkdonk606 collected $103.50 from pot
*** SUMMARY ***
Total pot $104 | Rake $0.50 
Board [Kh 4c 4h 4d Kc]
Seat 1: fightingnuns (button) (small blind) mucked [3c Jc]
Seat 2: donkdonk606 (big blind) showed [Ts Ks] and won ($103.50) with a full house, Kings full of Fours



PokerStars Game #59777374806:  Hold'em No Limit ($2/$4 USD) - 2011/03/25 12:38:00 ET
Table 'Ambrosia X' 2-max Seat #2 is the button
Seat 1: fightingnuns ($200 in chips) 
Seat 2: donkdonk606 ($673.80 in chips) 
donkdonk606: posts small blind $2
fightingnuns: posts big blind $4
*** HOLE CARDS ***
Dealt to fightingnuns [3c 9h]
donkdonk606: folds 
Uncalled bet ($2) returned to fightingnuns
fightingnuns collected $4 from pot
fightingnuns: doesn't show hand 
*** SUMMARY ***
Total pot $4 | Rake $0 
Seat 1: fightingnuns (big blind) collected ($4)
Seat 2: donkdonk606 (button) (small blind) folded before Flop



PokerStars Game #59777379226:  Hold'em No Limit ($2/$4 USD) - 2011/03/25 12:38:06 ET
Table 'Ambrosia X' 2-max Seat #1 is the button
Seat 1: fightingnuns ($202 in chips) 
Seat 2: donkdonk606 ($671.80 in chips) 
fightingnuns: posts small blind $2
donkdonk606: posts big blind $4
*** HOLE CARDS ***
Dealt to fightingnuns [2s Tc]
fightingnuns: folds 
Uncalled bet ($2) returned to donkdonk606
donkdonk606 collected $4 from pot
*** SUMMARY ***
Total pot $4 | Rake $0 
Seat 1: fightingnuns (button) (small blind) folded before Flop
Seat 2: donkdonk606 (big blind) collected ($4)



PokerStars Game #59777383637:  Hold'em No Limit ($2/$4 USD) - 2011/03/25 12:38:11 ET
Table 'Ambrosia X' 2-max Seat #2 is the button
Seat 1: fightingnuns ($200 in chips) 
Seat 2: donkdonk606 ($673.80 in chips) 
donkdonk606: posts small blind $2
fightingnuns: posts big blind $4
*** HOLE CARDS ***
Dealt to fightingnuns [6c 5s]
donkdonk606: folds 
Uncalled bet ($2) returned to fightingnuns
fightingnuns collected $4 from pot
fightingnuns: doesn't show hand 
*** SUMMARY ***
Total pot $4 | Rake $0 
Seat 1: fightingnuns (big blind) collected ($4)
Seat 2: donkdonk606 (button) (small blind) folded before Flop



PokerStars Game #59777388678:  Hold'em No Limit ($2/$4 USD) - 2011/03/25 12:38:18 ET
Table 'Ambrosia X' 2-max Seat #1 is the button
Seat 1: fightingnuns ($202 in chips) 
Seat 2: donkdonk606 ($671.80 in chips) 
fightingnuns: posts small blind $2
donkdonk606: posts big blind $4
*** HOLE CARDS ***
Dealt to fightingnuns [4h 7d]
fightingnuns: folds 
Uncalled bet ($2) returned to donkdonk606
donkdonk606 collected $4 from pot
*** SUMMARY ***
Total pot $4 | Rake $0 
Seat 1: fightingnuns (button) (small blind) folded before Flop
Seat 2: donkdonk606 (big blind) collected ($4)



PokerStars Game #59777392702:  Hold'em No Limit ($2/$4 USD) - 2011/03/25 12:38:23 ET
Table 'Ambrosia X' 2-max Seat #2 is the button
Seat 1: fightingnuns ($200 in chips) 
Seat 2: donkdonk606 ($673.80 in chips) 
donkdonk606: posts small blind $2
fightingnuns: posts big blind $4
*** HOLE CARDS ***
Dealt to fightingnuns [9c 9d]
donkdonk606: folds 
Uncalled bet ($2) returned to fightingnuns
fightingnuns collected $4 from pot
fightingnuns: doesn't show hand 
*** SUMMARY ***
Total pot $4 | Rake $0 
Seat 1: fightingnuns (big blind) collected ($4)
Seat 2: donkdonk606 (button) (small blind) folded before Flop



PokerStars Game #59777397616:  Hold'em No Limit ($2/$4 USD) - 2011/03/25 12:38:30 ET
Table 'Ambrosia X' 2-max Seat #1 is the button
Seat 1: fightingnuns ($202 in chips) 
Seat 2: donkdonk606 ($671.80 in chips) 
fightingnuns: posts small blind $2
donkdonk606: posts big blind $4
*** HOLE CARDS ***
Dealt to fightingnuns [6c Ts]
fightingnuns: raises $8 to $12
donkdonk606: folds 
Uncalled bet ($8) returned to fightingnuns
fightingnuns collected $8 from pot
fightingnuns: doesn't show hand 
*** SUMMARY ***
Total pot $8 | Rake $0 
Seat 1: fightingnuns (button) (small blind) collected ($8)
Seat 2: donkdonk606 (big blind) folded before Flop



PokerStars Game #59777404500:  Hold'em No Limit ($2/$4 USD) - 2011/03/25 12:38:39 ET
Table 'Ambrosia X' 2-max Seat #2 is the button
Seat 1: fightingnuns ($206 in chips) 
Seat 2: donkdonk606 ($667.80 in chips) 
donkdonk606: posts small blind $2
fightingnuns: posts big blind $4
*** HOLE CARDS ***
Dealt to fightingnuns [As 4c]
donkdonk606: folds 
Uncalled bet ($2) returned to fightingnuns
fightingnuns collected $4 from pot
fightingnuns: doesn't show hand 
*** SUMMARY ***
Total pot $4 | Rake $0 
Seat 1: fightingnuns (big blind) collected ($4)
Seat 2: donkdonk606 (button) (small blind) folded before Flop



PokerStars Game #59777409073:  Hold'em No Limit ($2/$4 USD) - 2011/03/25 12:38:45 ET
Table 'Ambrosia X' 2-max Seat #1 is the button
Seat 1: fightingnuns ($208 in chips) 
Seat 2: donkdonk606 ($665.80 in chips) 
fightingnuns: posts small blind $2
donkdonk606: posts big blind $4
*** HOLE CARDS ***
Dealt to fightingnuns [Jd Qh]
fightingnuns: raises $8 to $12
donkdonk606: folds 
Uncalled bet ($8) returned to fightingnuns
fightingnuns collected $8 from pot
fightingnuns: doesn't show hand 
*** SUMMARY ***
Total pot $8 | Rake $0 
Seat 1: fightingnuns (button) (small blind) collected ($8)
Seat 2: donkdonk606 (big blind) folded before Flop



PokerStars Game #59777416337:  Hold'em No Limit ($2/$4 USD) - 2011/03/25 12:38:54 ET
Table 'Ambrosia X' 2-max Seat #2 is the button
Seat 1: fightingnuns ($212 in chips) 
Seat 2: donkdonk606 ($661.80 in chips) 
donkdonk606: posts small blind $2
fightingnuns: posts big blind $4
*** HOLE CARDS ***
Dealt to fightingnuns [8h 4d]
donkdonk606: raises $4 to $8
fightingnuns: folds 
Uncalled bet ($4) returned to donkdonk606
donkdonk606 collected $8 from pot
donkdonk606: doesn't show hand 
*** SUMMARY ***
Total pot $8 | Rake $0 
Seat 1: fightingnuns (big blind) folded before Flop
Seat 2: donkdonk606 (button) (small blind) collected ($8)



PokerStars Game #59777422438:  Hold'em No Limit ($2/$4 USD) - 2011/03/25 12:39:02 ET
Table 'Ambrosia X' 2-max Seat #1 is the button
Seat 1: fightingnuns ($208 in chips) 
Seat 2: donkdonk606 ($665.80 in chips) 
fightingnuns: posts small blind $2
donkdonk606: posts big blind $4
*** HOLE CARDS ***
Dealt to fightingnuns [2h Jc]
fightingnuns: folds 
Uncalled bet ($2) returned to donkdonk606
donkdonk606 collected $4 from pot
donkdonk606: doesn't show hand 
*** SUMMARY ***
Total pot $4 | Rake $0 
Seat 1: fightingnuns (button) (small blind) folded before Flop
Seat 2: donkdonk606 (big blind) collected ($4)



PokerStars Game #59777426658:  Hold'em No Limit ($2/$4 USD) - 2011/03/25 12:39:08 ET
Table 'Ambrosia X' 2-max Seat #2 is the button
Seat 1: fightingnuns ($206 in chips) 
Seat 2: donkdonk606 ($667.80 in chips) 
donkdonk606: posts small blind $2
fightingnuns: posts big blind $4
*** HOLE CARDS ***
Dealt to fightingnuns [Jd Qh]
donkdonk606: folds 
Uncalled bet ($2) returned to fightingnuns
fightingnuns collected $4 from pot
fightingnuns: doesn't show hand 
*** SUMMARY ***
Total pot $4 | Rake $0 
Seat 1: fightingnuns (big blind) collected ($4)
Seat 2: donkdonk606 (button) (small blind) folded before Flop



PokerStars Game #59777430515:  Hold'em No Limit ($2/$4 USD) - 2011/03/25 12:39:13 ET
Table 'Ambrosia X' 2-max Seat #1 is the button
Seat 1: fightingnuns ($208 in chips) 
Seat 2: donkdonk606 ($665.80 in chips) 
fightingnuns: posts small blind $2
donkdonk606: posts big blind $4
*** HOLE CARDS ***
Dealt to fightingnuns [Ks 4s]
fightingnuns: raises $8 to $12
donkdonk606: calls $8
*** FLOP *** [Kd 6c 2d]
donkdonk606: bets $8
fightingnuns: calls $8
*** TURN *** [Kd 6c 2d] [6h]
donkdonk606: checks 
fightingnuns: bets $24
donkdonk606: folds 
Uncalled bet ($24) returned to fightingnuns
fightingnuns collected $39.50 from pot
fightingnuns: doesn't show hand 
*** SUMMARY ***
Total pot $40 | Rake $0.50 
Board [Kd 6c 2d 6h]
Seat 1: fightingnuns (button) (small blind) collected ($39.50)
Seat 2: donkdonk606 (big blind) folded on the Turn



PokerStars Game #59777456887:  Hold'em No Limit ($2/$4 USD) - 2011/03/25 12:39:47 ET
Table 'Ambrosia X' 2-max Seat #2 is the button
Seat 1: fightingnuns ($227.50 in chips) 
Seat 2: donkdonk606 ($645.80 in chips) 
donkdonk606: posts small blind $2
fightingnuns: posts big blind $4
*** HOLE CARDS ***
Dealt to fightingnuns [Ah 4h]
donkdonk606: folds 
Uncalled bet ($2) returned to fightingnuns
fightingnuns collected $4 from pot
fightingnuns: doesn't show hand 
*** SUMMARY ***
Total pot $4 | Rake $0 
Seat 1: fightingnuns (big blind) collected ($4)
Seat 2: donkdonk606 (button) (small blind) folded before Flop



PokerStars Game #59777461328:  Hold'em No Limit ($2/$4 USD) - 2011/03/25 12:39:53 ET
Table 'Ambrosia X' 2-max Seat #1 is the button
Seat 1: fightingnuns ($229.50 in chips) 
Seat 2: donkdonk606 ($643.80 in chips) 
fightingnuns: posts small blind $2
donkdonk606: posts big blind $4
*** HOLE CARDS ***
Dealt to fightingnuns [Kh 4c]
fightingnuns: folds 
Uncalled bet ($2) returned to donkdonk606
donkdonk606 collected $4 from pot
*** SUMMARY ***
Total pot $4 | Rake $0 
Seat 1: fightingnuns (button) (small blind) folded before Flop
Seat 2: donkdonk606 (big blind) collected ($4)



PokerStars Game #59777466030:  Hold'em No Limit ($2/$4 USD) - 2011/03/25 12:39:59 ET
Table 'Ambrosia X' 2-max Seat #2 is the button
Seat 1: fightingnuns ($227.50 in chips) 
Seat 2: donkdonk606 ($645.80 in chips) 
donkdonk606: posts small blind $2
fightingnuns: posts big blind $4
*** HOLE CARDS ***
Dealt to fightingnuns [3c 9s]
donkdonk606: folds 
Uncalled bet ($2) returned to fightingnuns
fightingnuns collected $4 from pot
fightingnuns: doesn't show hand 
*** SUMMARY ***
Total pot $4 | Rake $0 
Seat 1: fightingnuns (big blind) collected ($4)
Seat 2: donkdonk606 (button) (small blind) folded before Flop



PokerStars Game #59777470066:  Hold'em No Limit ($2/$4 USD) - 2011/03/25 12:40:04 ET
Table 'Ambrosia X' 2-max Seat #1 is the button
Seat 1: fightingnuns ($229.50 in chips) 
Seat 2: donkdonk606 ($643.80 in chips) 
fightingnuns: posts small blind $2
donkdonk606: posts big blind $4
*** HOLE CARDS ***
Dealt to fightingnuns [Ac Ts]
fightingnuns: raises $8 to $12
donkdonk606: folds 
Uncalled bet ($8) returned to fightingnuns
fightingnuns collected $8 from pot
fightingnuns: doesn't show hand 
*** SUMMARY ***
Total pot $8 | Rake $0 
Seat 1: fightingnuns (button) (small blind) collected ($8)
Seat 2: donkdonk606 (big blind) folded before Flop



PokerStars Game #59777476430:  Hold'em No Limit ($2/$4 USD) - 2011/03/25 12:40:12 ET
Table 'Ambrosia X' 2-max Seat #2 is the button
Seat 1: fightingnuns ($233.50 in chips) 
Seat 2: donkdonk606 ($639.80 in chips) 
donkdonk606: posts small blind $2
fightingnuns: posts big blind $4
*** HOLE CARDS ***
Dealt to fightingnuns [Qc 6h]
donkdonk606: raises $4 to $8
fightingnuns: folds 
Uncalled bet ($4) returned to donkdonk606
donkdonk606 collected $8 from pot
donkdonk606: doesn't show hand 
*** SUMMARY ***
Total pot $8 | Rake $0 
Seat 1: fightingnuns (big blind) folded before Flop
Seat 2: donkdonk606 (button) (small blind) collected ($8)



PokerStars Game #59777482008:  Hold'em No Limit ($2/$4 USD) - 2011/03/25 12:40:20 ET
Table 'Ambrosia X' 2-max Seat #1 is the button
Seat 1: fightingnuns ($229.50 in chips) 
Seat 2: donkdonk606 ($643.80 in chips) 
fightingnuns: posts small blind $2
donkdonk606: posts big blind $4
*** HOLE CARDS ***
Dealt to fightingnuns [6d Qh]
fightingnuns: raises $8 to $12
donkdonk606: folds 
Uncalled bet ($8) returned to fightingnuns
fightingnuns collected $8 from pot
fightingnuns: doesn't show hand 
*** SUMMARY ***
Total pot $8 | Rake $0 
Seat 1: fightingnuns (button) (small blind) collected ($8)
Seat 2: donkdonk606 (big blind) folded before Flop



PokerStars Game #59777488534:  Hold'em No Limit ($2/$4 USD) - 2011/03/25 12:40:29 ET
Table 'Ambrosia X' 2-max Seat #2 is the button
Seat 1: fightingnuns ($233.50 in chips) 
Seat 2: donkdonk606 ($639.80 in chips) 
donkdonk606: posts small blind $2
fightingnuns: posts big blind $4
*** HOLE CARDS ***
Dealt to fightingnuns [Jh 5c]
donkdonk606: raises $4 to $8
fightingnuns: folds 
Uncalled bet ($4) returned to donkdonk606
donkdonk606 collected $8 from pot
donkdonk606: doesn't show hand 
*** SUMMARY ***
Total pot $8 | Rake $0 
Seat 1: fightingnuns (big blind) folded before Flop
Seat 2: donkdonk606 (button) (small blind) collected ($8)



PokerStars Game #59777499762:  Hold'em No Limit ($2/$4 USD) - 2011/03/25 12:40:43 ET
Table 'Ambrosia X' 2-max Seat #1 is the button
Seat 1: fightingnuns ($229.50 in chips) 
Seat 2: donkdonk606 ($643.80 in chips) 
fightingnuns: posts small blind $2
donkdonk606: posts big blind $4
*** HOLE CARDS ***
Dealt to fightingnuns [Kc 7s]
fightingnuns: raises $8 to $12
donkdonk606: calls $8
*** FLOP *** [7h 9c Td]
donkdonk606: checks 
fightingnuns: checks 
*** TURN *** [7h 9c Td] [8h]
donkdonk606: checks 
fightingnuns: checks 
*** RIVER *** [7h 9c Td 8h] [8s]
donkdonk606: checks 
fightingnuns: checks 
*** SHOW DOWN ***
donkdonk606: shows [6s Ts] (a straight, Six to Ten)
fightingnuns: mucks hand 
donkdonk606 collected $23.50 from pot
*** SUMMARY ***
Total pot $24 | Rake $0.50 
Board [7h 9c Td 8h 8s]
Seat 1: fightingnuns (button) (small blind) mucked [Kc 7s]
Seat 2: donkdonk606 (big blind) showed [6s Ts] and won ($23.50) with a straight, Six to Ten



PokerStars Game #59777525048:  Hold'em No Limit ($2/$4 USD) - 2011/03/25 12:41:16 ET
Table 'Ambrosia X' 2-max Seat #2 is the button
Seat 1: fightingnuns ($217.50 in chips) 
Seat 2: donkdonk606 ($655.30 in chips) 
donkdonk606: posts small blind $2
fightingnuns: posts big blind $4
*** HOLE CARDS ***
Dealt to fightingnuns [4c 7d]
donkdonk606: folds 
Uncalled bet ($2) returned to fightingnuns
fightingnuns collected $4 from pot
fightingnuns: doesn't show hand 
*** SUMMARY ***
Total pot $4 | Rake $0 
Seat 1: fightingnuns (big blind) collected ($4)
Seat 2: donkdonk606 (button) (small blind) folded before Flop



PokerStars Game #59777529555:  Hold'em No Limit ($2/$4 USD) - 2011/03/25 12:41:21 ET
Table 'Ambrosia X' 2-max Seat #1 is the button
Seat 1: fightingnuns ($219.50 in chips) 
Seat 2: donkdonk606 ($653.30 in chips) 
fightingnuns: posts small blind $2
donkdonk606: posts big blind $4
*** HOLE CARDS ***
Dealt to fightingnuns [Th 9h]
fightingnuns: raises $8 to $12
donkdonk606: calls $8
*** FLOP *** [8s Qs 8h]
donkdonk606: bets $4
fightingnuns: raises $12 to $16
donkdonk606: calls $12
*** TURN *** [8s Qs 8h] [2d]
donkdonk606: bets $32
fightingnuns: folds 
Uncalled bet ($32) returned to donkdonk606
donkdonk606 collected $55.50 from pot
donkdonk606: doesn't show hand 
*** SUMMARY ***
Total pot $56 | Rake $0.50 
Board [8s Qs 8h 2d]
Seat 1: fightingnuns (button) (small blind) folded on the Turn
Seat 2: donkdonk606 (big blind) collected ($55.50)



PokerStars Game #59777549623:  Hold'em No Limit ($2/$4 USD) - 2011/03/25 12:41:48 ET
Table 'Ambrosia X' 2-max Seat #2 is the button
Seat 1: fightingnuns ($200 in chips) 
Seat 2: donkdonk606 ($680.80 in chips) 
donkdonk606: posts small blind $2
fightingnuns: posts big blind $4
*** HOLE CARDS ***
Dealt to fightingnuns [9d Kh]
donkdonk606: folds 
Uncalled bet ($2) returned to fightingnuns
fightingnuns collected $4 from pot
fightingnuns: doesn't show hand 
*** SUMMARY ***
Total pot $4 | Rake $0 
Seat 1: fightingnuns (big blind) collected ($4)
Seat 2: donkdonk606 (button) (small blind) folded before Flop



PokerStars Game #59777555626:  Hold'em No Limit ($2/$4 USD) - 2011/03/25 12:41:55 ET
Table 'Ambrosia X' 2-max Seat #1 is the button
Seat 1: fightingnuns ($202 in chips) 
Seat 2: donkdonk606 ($678.80 in chips) 
fightingnuns: posts small blind $2
donkdonk606: posts big blind $4
*** HOLE CARDS ***
Dealt to fightingnuns [7s 2s]
fightingnuns: raises $8 to $12
donkdonk606: folds 
Uncalled bet ($8) returned to fightingnuns
fightingnuns collected $8 from pot
fightingnuns: doesn't show hand 
*** SUMMARY ***
Total pot $8 | Rake $0 
Seat 1: fightingnuns (button) (small blind) collected ($8)
Seat 2: donkdonk606 (big blind) folded before Flop



PokerStars Game #59777564336:  Hold'em No Limit ($2/$4 USD) - 2011/03/25 12:42:06 ET
Table 'Ambrosia X' 2-max Seat #2 is the button
Seat 1: fightingnuns ($206 in chips) 
Seat 2: donkdonk606 ($674.80 in chips) 
donkdonk606: posts small blind $2
fightingnuns: posts big blind $4
*** HOLE CARDS ***
Dealt to fightingnuns [Jc As]
donkdonk606: folds 
Uncalled bet ($2) returned to fightingnuns
fightingnuns collected $4 from pot
fightingnuns: doesn't show hand 
*** SUMMARY ***
Total pot $4 | Rake $0 
Seat 1: fightingnuns (big blind) collected ($4)
Seat 2: donkdonk606 (button) (small blind) folded before Flop



PokerStars Game #59777568467:  Hold'em No Limit ($2/$4 USD) - 2011/03/25 12:42:11 ET
Table 'Ambrosia X' 2-max Seat #1 is the button
Seat 1: fightingnuns ($208 in chips) 
Seat 2: donkdonk606 ($672.80 in chips) 
fightingnuns: posts small blind $2
donkdonk606: posts big blind $4
*** HOLE CARDS ***
Dealt to fightingnuns [Qd 6s]
fightingnuns: raises $8 to $12
donkdonk606: calls $8
*** FLOP *** [2h Ac 3s]
donkdonk606: bets $8
fightingnuns: folds 
Uncalled bet ($8) returned to donkdonk606
donkdonk606 collected $23.50 from pot
*** SUMMARY ***
Total pot $24 | Rake $0.50 
Board [2h Ac 3s]
Seat 1: fightingnuns (button) (small blind) folded on the Flop
Seat 2: donkdonk606 (big blind) collected ($23.50)



PokerStars Game #59777580857:  Hold'em No Limit ($2/$4 USD) - 2011/03/25 12:42:27 ET
Table 'Ambrosia X' 2-max Seat #2 is the button
Seat 1: fightingnuns ($200 in chips) 
Seat 2: donkdonk606 ($684.30 in chips) 
donkdonk606: posts small blind $2
fightingnuns: posts big blind $4
*** HOLE CARDS ***
Dealt to fightingnuns [9c 7d]
donkdonk606: calls $2
fightingnuns: raises $12 to $16
donkdonk606: folds 
Uncalled bet ($12) returned to fightingnuns
fightingnuns collected $8 from pot
*** SUMMARY ***
Total pot $8 | Rake $0 
Seat 1: fightingnuns (big blind) collected ($8)
Seat 2: donkdonk606 (button) (small blind) folded before Flop



PokerStars Game #59777589942:  Hold'em No Limit ($2/$4 USD) - 2011/03/25 12:42:39 ET
Table 'Ambrosia X' 2-max Seat #1 is the button
Seat 1: fightingnuns ($204 in chips) 
Seat 2: donkdonk606 ($680.30 in chips) 
fightingnuns: posts small blind $2
donkdonk606: posts big blind $4
*** HOLE CARDS ***
Dealt to fightingnuns [Ad 3c]
fightingnuns: raises $8 to $12
donkdonk606: calls $8
*** FLOP *** [6s 7s 9d]
donkdonk606: bets $8
fightingnuns: folds 
Uncalled bet ($8) returned to donkdonk606
donkdonk606 collected $23.50 from pot
donkdonk606: doesn't show hand 
*** SUMMARY ***
Total pot $24 | Rake $0.50 
Board [6s 7s 9d]
Seat 1: fightingnuns (button) (small blind) folded on the Flop
Seat 2: donkdonk606 (big blind) collected ($23.50)



PokerStars Game #59777602181:  Hold'em No Limit ($2/$4 USD) - 2011/03/25 12:42:55 ET
Table 'Ambrosia X' 2-max Seat #2 is the button
Seat 1: fightingnuns ($200 in chips) 
Seat 2: donkdonk606 ($691.80 in chips) 
donkdonk606: posts small blind $2
fightingnuns: posts big blind $4
*** HOLE CARDS ***
Dealt to fightingnuns [3s Kh]
donkdonk606: raises $4 to $8
fightingnuns: folds 
Uncalled bet ($4) returned to donkdonk606
donkdonk606 collected $8 from pot
donkdonk606: doesn't show hand 
*** SUMMARY ***
Total pot $8 | Rake $0 
Seat 1: fightingnuns (big blind) folded before Flop
Seat 2: donkdonk606 (button) (small blind) collected ($8)



PokerStars Game #59777608498:  Hold'em No Limit ($2/$4 USD) - 2011/03/25 12:43:03 ET
Table 'Ambrosia X' 2-max Seat #1 is the button
Seat 1: fightingnuns ($200 in chips) 
Seat 2: donkdonk606 ($695.80 in chips) 
fightingnuns: posts small blind $2
donkdonk606: posts big blind $4
*** HOLE CARDS ***
Dealt to fightingnuns [5h 2h]
fightingnuns: raises $8 to $12
donkdonk606: folds 
Uncalled bet ($8) returned to fightingnuns
fightingnuns collected $8 from pot
fightingnuns: doesn't show hand 
*** SUMMARY ***
Total pot $8 | Rake $0 
Seat 1: fightingnuns (button) (small blind) collected ($8)
Seat 2: donkdonk606 (big blind) folded before Flop



PokerStars Game #59777616461:  Hold'em No Limit ($2/$4 USD) - 2011/03/25 12:43:13 ET
Table 'Ambrosia X' 2-max Seat #2 is the button
Seat 1: fightingnuns ($204 in chips) 
Seat 2: donkdonk606 ($691.80 in chips) 
donkdonk606: posts small blind $2
fightingnuns: posts big blind $4
*** HOLE CARDS ***
Dealt to fightingnuns [4c 8h]
donkdonk606: folds 
Uncalled bet ($2) returned to fightingnuns
fightingnuns collected $4 from pot
fightingnuns: doesn't show hand 
*** SUMMARY ***
Total pot $4 | Rake $0 
Seat 1: fightingnuns (big blind) collected ($4)
Seat 2: donkdonk606 (button) (small blind) folded before Flop



PokerStars Game #59777621645:  Hold'em No Limit ($2/$4 USD) - 2011/03/25 12:43:20 ET
Table 'Ambrosia X' 2-max Seat #1 is the button
Seat 1: fightingnuns ($206 in chips) 
Seat 2: donkdonk606 ($689.80 in chips) 
fightingnuns: posts small blind $2
donkdonk606: posts big blind $4
*** HOLE CARDS ***
Dealt to fightingnuns [6h 4h]
fightingnuns: raises $4 to $8
donkdonk606: calls $4
*** FLOP *** [7d 8c 2s]
donkdonk606: checks 
fightingnuns: bets $12
donkdonk606: folds 
Uncalled bet ($12) returned to fightingnuns
fightingnuns collected $15.50 from pot
fightingnuns: doesn't show hand 
*** SUMMARY ***
Total pot $16 | Rake $0.50 
Board [7d 8c 2s]
Seat 1: fightingnuns (button) (small blind) collected ($15.50)
Seat 2: donkdonk606 (big blind) folded on the Flop



PokerStars Game #59777638158:  Hold'em No Limit ($2/$4 USD) - 2011/03/25 12:43:42 ET
Table 'Ambrosia X' 2-max Seat #2 is the button
Seat 1: fightingnuns ($213.50 in chips) 
Seat 2: donkdonk606 ($681.80 in chips) 
donkdonk606: posts small blind $2
fightingnuns: posts big blind $4
*** HOLE CARDS ***
Dealt to fightingnuns [5d Kc]
donkdonk606: raises $4 to $8
fightingnuns: folds 
Uncalled bet ($4) returned to donkdonk606
donkdonk606 collected $8 from pot
donkdonk606: doesn't show hand 
*** SUMMARY ***
Total pot $8 | Rake $0 
Seat 1: fightingnuns (big blind) folded before Flop
Seat 2: donkdonk606 (button) (small blind) collected ($8)



PokerStars Game #59777645069:  Hold'em No Limit ($2/$4 USD) - 2011/03/25 12:43:50 ET
Table 'Ambrosia X' 2-max Seat #1 is the button
Seat 1: fightingnuns ($209.50 in chips) 
Seat 2: donkdonk606 ($685.80 in chips) 
fightingnuns: posts small blind $2
donkdonk606: posts big blind $4
*** HOLE CARDS ***
Dealt to fightingnuns [9d 7d]
fightingnuns: raises $4 to $8
donkdonk606: calls $4
*** FLOP *** [3s Ts 2h]
donkdonk606: bets $8
fightingnuns: folds 
Uncalled bet ($8) returned to donkdonk606
donkdonk606 collected $15.50 from pot
donkdonk606: doesn't show hand 
*** SUMMARY ***
Total pot $16 | Rake $0.50 
Board [3s Ts 2h]
Seat 1: fightingnuns (button) (small blind) folded on the Flop
Seat 2: donkdonk606 (big blind) collected ($15.50)



PokerStars Game #59777658001:  Hold'em No Limit ($2/$4 USD) - 2011/03/25 12:44:07 ET
Table 'Ambrosia X' 2-max Seat #2 is the button
Seat 1: fightingnuns ($201.50 in chips) 
Seat 2: donkdonk606 ($693.30 in chips) 
donkdonk606: posts small blind $2
fightingnuns: posts big blind $4
*** HOLE CARDS ***
Dealt to fightingnuns [8d 5s]
donkdonk606: folds 
Uncalled bet ($2) returned to fightingnuns
fightingnuns collected $4 from pot
fightingnuns: doesn't show hand 
*** SUMMARY ***
Total pot $4 | Rake $0 
Seat 1: fightingnuns (big blind) collected ($4)
Seat 2: donkdonk606 (button) (small blind) folded before Flop



PokerStars Game #59777661966:  Hold'em No Limit ($2/$4 USD) - 2011/03/25 12:44:12 ET
Table 'Ambrosia X' 2-max Seat #1 is the button
Seat 1: fightingnuns ($203.50 in chips) 
Seat 2: donkdonk606 ($691.30 in chips) 
fightingnuns: posts small blind $2
donkdonk606: posts big blind $4
*** HOLE CARDS ***
Dealt to fightingnuns [7h Td]
fightingnuns: raises $4 to $8
donkdonk606: calls $4
*** FLOP *** [4d Qh 5s]
donkdonk606: bets $4
fightingnuns: folds 
Uncalled bet ($4) returned to donkdonk606
donkdonk606 collected $15.50 from pot
*** SUMMARY ***
Total pot $16 | Rake $0.50 
Board [4d Qh 5s]
Seat 1: fightingnuns (button) (small blind) folded on the Flop
Seat 2: donkdonk606 (big blind) collected ($15.50)



PokerStars Game #59777675771:  Hold'em No Limit ($2/$4 USD) - 2011/03/25 12:44:30 ET
Table 'Ambrosia X' 2-max Seat #2 is the button
Seat 1: fightingnuns ($200 in chips) 
Seat 2: donkdonk606 ($698.80 in chips) 
donkdonk606: posts small blind $2
fightingnuns: posts big blind $4
*** HOLE CARDS ***
Dealt to fightingnuns [9c Js]
donkdonk606: calls $2
fightingnuns: checks 
*** FLOP *** [4c Kd Qc]
fightingnuns: checks 
donkdonk606: bets $4
fightingnuns: calls $4
*** TURN *** [4c Kd Qc] [Kc]
fightingnuns: checks 
donkdonk606: checks 
*** RIVER *** [4c Kd Qc Kc] [9d]
fightingnuns: bets $8
donkdonk606: folds 
Uncalled bet ($8) returned to fightingnuns
fightingnuns collected $15.50 from pot
fightingnuns: doesn't show hand 
*** SUMMARY ***
Total pot $16 | Rake $0.50 
Board [4c Kd Qc Kc 9d]
Seat 1: fightingnuns (big blind) collected ($15.50)
Seat 2: donkdonk606 (button) (small blind) folded on the River



PokerStars Game #59777695786:  Hold'em No Limit ($2/$4 USD) - 2011/03/25 12:44:56 ET
Table 'Ambrosia X' 2-max Seat #1 is the button
Seat 1: fightingnuns ($207.50 in chips) 
Seat 2: donkdonk606 ($690.80 in chips) 
fightingnuns: posts small blind $2
donkdonk606: posts big blind $4
*** HOLE CARDS ***
Dealt to fightingnuns [Tc 9h]
fightingnuns: raises $4 to $8
donkdonk606: calls $4
*** FLOP *** [Jc Qc 6c]
donkdonk606: bets $4
fightingnuns: raises $8 to $12
donkdonk606: calls $8
*** TURN *** [Jc Qc 6c] [Qh]
donkdonk606: bets $8
fightingnuns: raises $20 to $28
donkdonk606: folds 
Uncalled bet ($20) returned to fightingnuns
fightingnuns collected $55.50 from pot
*** SUMMARY ***
Total pot $56 | Rake $0.50 
Board [Jc Qc 6c Qh]
Seat 1: fightingnuns (button) (small blind) collected ($55.50)
Seat 2: donkdonk606 (big blind) folded on the Turn



PokerStars Game #59777717982:  Hold'em No Limit ($2/$4 USD) - 2011/03/25 12:45:23 ET
Table 'Ambrosia X' 2-max Seat #2 is the button
Seat 1: fightingnuns ($235 in chips) 
Seat 2: donkdonk606 ($662.80 in chips) 
donkdonk606: posts small blind $2
fightingnuns: posts big blind $4
*** HOLE CARDS ***
Dealt to fightingnuns [Ks Th]
donkdonk606: folds 
Uncalled bet ($2) returned to fightingnuns
fightingnuns collected $4 from pot
fightingnuns: doesn't show hand 
*** SUMMARY ***
Total pot $4 | Rake $0 
Seat 1: fightingnuns (big blind) collected ($4)
Seat 2: donkdonk606 (button) (small blind) folded before Flop



PokerStars Game #59777722891:  Hold'em No Limit ($2/$4 USD) - 2011/03/25 12:45:30 ET
Table 'Ambrosia X' 2-max Seat #1 is the button
Seat 1: fightingnuns ($237 in chips) 
Seat 2: donkdonk606 ($660.80 in chips) 
fightingnuns: posts small blind $2
donkdonk606: posts big blind $4
*** HOLE CARDS ***
Dealt to fightingnuns [7s Kc]
fightingnuns: raises $4 to $8
donkdonk606: calls $4
*** FLOP *** [7c Td 7d]
donkdonk606: checks 
fightingnuns: bets $8
donkdonk606: folds 
Uncalled bet ($8) returned to fightingnuns
fightingnuns collected $15.50 from pot
fightingnuns: doesn't show hand 
*** SUMMARY ***
Total pot $16 | Rake $0.50 
Board [7c Td 7d]
Seat 1: fightingnuns (button) (small blind) collected ($15.50)
Seat 2: donkdonk606 (big blind) folded on the Flop



PokerStars Game #59777735920:  Hold'em No Limit ($2/$4 USD) - 2011/03/25 12:45:47 ET
Table 'Ambrosia X' 2-max Seat #2 is the button
Seat 1: fightingnuns ($244.50 in chips) 
Seat 2: donkdonk606 ($652.80 in chips) 
donkdonk606: posts small blind $2
fightingnuns: posts big blind $4
*** HOLE CARDS ***
Dealt to fightingnuns [Ts Qh]
donkdonk606: raises $4 to $8
fightingnuns: calls $4
*** FLOP *** [4d 7c 4h]
fightingnuns: checks 
donkdonk606: bets $8
fightingnuns: folds 
Uncalled bet ($8) returned to donkdonk606
donkdonk606 collected $15.50 from pot
donkdonk606: doesn't show hand 
*** SUMMARY ***
Total pot $16 | Rake $0.50 
Board [4d 7c 4h]
Seat 1: fightingnuns (big blind) folded on the Flop
Seat 2: donkdonk606 (button) (small blind) collected ($15.50)



PokerStars Game #59777750313:  Hold'em No Limit ($2/$4 USD) - 2011/03/25 12:46:05 ET
Table 'Ambrosia X' 2-max Seat #1 is the button
Seat 1: fightingnuns ($236.50 in chips) 
Seat 2: donkdonk606 ($660.30 in chips) 
fightingnuns: posts small blind $2
donkdonk606: posts big blind $4
*** HOLE CARDS ***
Dealt to fightingnuns [8h 6c]
fightingnuns: raises $4 to $8
donkdonk606: raises $8 to $16
fightingnuns: calls $8
*** FLOP *** [Kc 5c 9c]
donkdonk606: checks 
fightingnuns: checks 
*** TURN *** [Kc 5c 9c] [4h]
donkdonk606: bets $8
fightingnuns: folds 
Uncalled bet ($8) returned to donkdonk606
donkdonk606 collected $31.50 from pot
donkdonk606: doesn't show hand 
*** SUMMARY ***
Total pot $32 | Rake $0.50 
Board [Kc 5c 9c 4h]
Seat 1: fightingnuns (button) (small blind) folded on the Turn
Seat 2: donkdonk606 (big blind) collected ($31.50)



PokerStars Game #59777775787:  Hold'em No Limit ($2/$4 USD) - 2011/03/25 12:46:38 ET
Table 'Ambrosia X' 2-max Seat #2 is the button
Seat 1: fightingnuns ($220.50 in chips) 
Seat 2: donkdonk606 ($675.80 in chips) 
donkdonk606: posts small blind $2
fightingnuns: posts big blind $4
*** HOLE CARDS ***
Dealt to fightingnuns [8c 4d]
donkdonk606: calls $2
fightingnuns: checks 
*** FLOP *** [Tc 6h 9h]
fightingnuns: checks 
donkdonk606: bets $4
fightingnuns: folds 
Uncalled bet ($4) returned to donkdonk606
donkdonk606 collected $7.60 from pot
donkdonk606: doesn't show hand 
*** SUMMARY ***
Total pot $8 | Rake $0.40 
Board [Tc 6h 9h]
Seat 1: fightingnuns (big blind) folded on the Flop
Seat 2: donkdonk606 (button) (small blind) collected ($7.60)



PokerStars Game #59777787289:  Hold'em No Limit ($2/$4 USD) - 2011/03/25 12:46:53 ET
Table 'Ambrosia X' 2-max Seat #1 is the button
Seat 1: fightingnuns ($216.50 in chips) 
Seat 2: donkdonk606 ($679.40 in chips) 
fightingnuns: posts small blind $2
donkdonk606: posts big blind $4
*** HOLE CARDS ***
Dealt to fightingnuns [7d 4h]
fightingnuns: folds 
Uncalled bet ($2) returned to donkdonk606
donkdonk606 collected $4 from pot
donkdonk606: doesn't show hand 
*** SUMMARY ***
Total pot $4 | Rake $0 
Seat 1: fightingnuns (button) (small blind) folded before Flop
Seat 2: donkdonk606 (big blind) collected ($4)



PokerStars Game #59777791598:  Hold'em No Limit ($2/$4 USD) - 2011/03/25 12:46:58 ET
Table 'Ambrosia X' 2-max Seat #2 is the button
Seat 1: fightingnuns ($214.50 in chips) 
Seat 2: donkdonk606 ($681.40 in chips) 
donkdonk606: posts small blind $2
fightingnuns: posts big blind $4
*** HOLE CARDS ***
Dealt to fightingnuns [8d 7s]
donkdonk606: raises $4 to $8
fightingnuns: raises $16 to $24
donkdonk606: folds 
Uncalled bet ($16) returned to fightingnuns
fightingnuns collected $16 from pot
fightingnuns: doesn't show hand 
*** SUMMARY ***
Total pot $16 | Rake $0 
Seat 1: fightingnuns (big blind) collected ($16)
Seat 2: donkdonk606 (button) (small blind) folded before Flop



PokerStars Game #59777802504:  Hold'em No Limit ($2/$4 USD) - 2011/03/25 12:47:11 ET
Table 'Ambrosia X' 2-max Seat #1 is the button
Seat 1: fightingnuns ($222.50 in chips) 
Seat 2: donkdonk606 ($673.40 in chips) 
fightingnuns: posts small blind $2
donkdonk606: posts big blind $4
*** HOLE CARDS ***
Dealt to fightingnuns [Td 7s]
fightingnuns: raises $4 to $8
donkdonk606: calls $4
*** FLOP *** [3c 9s 8c]
donkdonk606: bets $8
fightingnuns: calls $8
*** TURN *** [3c 9s 8c] [9c]
donkdonk606: bets $16
fightingnuns: calls $16
*** RIVER *** [3c 9s 8c 9c] [Th]
donkdonk606: checks 
fightingnuns: bets $32
donkdonk606: calls $32
*** SHOW DOWN ***
fightingnuns: shows [Td 7s] (two pair, Tens and Nines)
donkdonk606: shows [Jh Qs] (a straight, Eight to Queen)
donkdonk606 collected $127.50 from pot
*** SUMMARY ***
Total pot $128 | Rake $0.50 
Board [3c 9s 8c 9c Th]
Seat 1: fightingnuns (button) (small blind) showed [Td 7s] and lost with two pair, Tens and Nines
Seat 2: donkdonk606 (big blind) showed [Jh Qs] and won ($127.50) with a straight, Eight to Queen



PokerStars Game #59777833712:  Hold'em No Limit ($2/$4 USD) - 2011/03/25 12:47:51 ET
Table 'Ambrosia X' 2-max Seat #2 is the button
Seat 1: fightingnuns ($200 in chips) 
Seat 2: donkdonk606 ($736.90 in chips) 
donkdonk606: posts small blind $2
fightingnuns: posts big blind $4
*** HOLE CARDS ***
Dealt to fightingnuns [5c 3d]
donkdonk606: folds 
Uncalled bet ($2) returned to fightingnuns
fightingnuns collected $4 from pot
fightingnuns: doesn't show hand 
*** SUMMARY ***
Total pot $4 | Rake $0 
Seat 1: fightingnuns (big blind) collected ($4)
Seat 2: donkdonk606 (button) (small blind) folded before Flop



PokerStars Game #59777838334:  Hold'em No Limit ($2/$4 USD) - 2011/03/25 12:47:57 ET
Table 'Ambrosia X' 2-max Seat #1 is the button
Seat 1: fightingnuns ($202 in chips) 
Seat 2: donkdonk606 ($734.90 in chips) 
fightingnuns: posts small blind $2
donkdonk606: posts big blind $4
*** HOLE CARDS ***
Dealt to fightingnuns [Js Qc]
fightingnuns: raises $4 to $8
donkdonk606: calls $4
*** FLOP *** [Kc Jd 4s]
donkdonk606: checks 
fightingnuns: bets $12
donkdonk606: calls $12
*** TURN *** [Kc Jd 4s] [Jc]
donkdonk606: checks 
fightingnuns: bets $32
donkdonk606: calls $32
*** RIVER *** [Kc Jd 4s Jc] [3d]
donkdonk606: bets $44
fightingnuns: raises $106 to $150 and is all-in
donkdonk606: folds 
Uncalled bet ($106) returned to fightingnuns
fightingnuns collected $191.50 from pot
fightingnuns: doesn't show hand 
*** SUMMARY ***
Total pot $192 | Rake $0.50 
Board [Kc Jd 4s Jc 3d]
Seat 1: fightingnuns (button) (small blind) collected ($191.50)
Seat 2: donkdonk606 (big blind) folded on the River



PokerStars Game #59777878715:  Hold'em No Limit ($2/$4 USD) - 2011/03/25 12:48:49 ET
Table 'Ambrosia X' 2-max Seat #2 is the button
Seat 1: fightingnuns ($297.50 in chips) 
Seat 2: donkdonk606 ($638.90 in chips) 
donkdonk606: posts small blind $2
fightingnuns: posts big blind $4
*** HOLE CARDS ***
Dealt to fightingnuns [2h 6s]
donkdonk606: folds 
Uncalled bet ($2) returned to fightingnuns
fightingnuns collected $4 from pot
fightingnuns: doesn't show hand 
*** SUMMARY ***
Total pot $4 | Rake $0 
Seat 1: fightingnuns (big blind) collected ($4)
Seat 2: donkdonk606 (button) (small blind) folded before Flop



PokerStars Game #59777882760:  Hold'em No Limit ($2/$4 USD) - 2011/03/25 12:48:54 ET
Table 'Ambrosia X' 2-max Seat #1 is the button
Seat 1: fightingnuns ($299.50 in chips) 
Seat 2: donkdonk606 ($636.90 in chips) 
fightingnuns: posts small blind $2
donkdonk606: posts big blind $4
*** HOLE CARDS ***
Dealt to fightingnuns [8d 7s]
fightingnuns: raises $8 to $12
donkdonk606: folds 
Uncalled bet ($8) returned to fightingnuns
fightingnuns collected $8 from pot
fightingnuns: doesn't show hand 
*** SUMMARY ***
Total pot $8 | Rake $0 
Seat 1: fightingnuns (button) (small blind) collected ($8)
Seat 2: donkdonk606 (big blind) folded before Flop



PokerStars Game #59777890758:  Hold'em No Limit ($2/$4 USD) - 2011/03/25 12:49:04 ET
Table 'Ambrosia X' 2-max Seat #2 is the button
Seat 1: fightingnuns ($303.50 in chips) 
Seat 2: donkdonk606 ($632.90 in chips) 
donkdonk606: posts small blind $2
fightingnuns: posts big blind $4
*** HOLE CARDS ***
Dealt to fightingnuns [Kh 3h]
donkdonk606: raises $4 to $8
fightingnuns: calls $4
*** FLOP *** [Ks 5s 8s]
fightingnuns: bets $12
donkdonk606: folds 
Uncalled bet ($12) returned to fightingnuns
fightingnuns collected $15.50 from pot
fightingnuns: doesn't show hand 
*** SUMMARY ***
Total pot $16 | Rake $0.50 
Board [Ks 5s 8s]
Seat 1: fightingnuns (big blind) collected ($15.50)
Seat 2: donkdonk606 (button) (small blind) folded on the Flop



PokerStars Game #59777903953:  Hold'em No Limit ($2/$4 USD) - 2011/03/25 12:49:21 ET
Table 'Ambrosia X' 2-max Seat #1 is the button
Seat 1: fightingnuns ($311 in chips) 
Seat 2: donkdonk606 ($624.90 in chips) 
fightingnuns: posts small blind $2
donkdonk606: posts big blind $4
*** HOLE CARDS ***
Dealt to fightingnuns [6c Ks]
fightingnuns: raises $8 to $12
donkdonk606: calls $8
*** FLOP *** [7c Ah 4h]
donkdonk606: bets $8
fightingnuns: folds 
Uncalled bet ($8) returned to donkdonk606
donkdonk606 collected $23.50 from pot
donkdonk606: doesn't show hand 
*** SUMMARY ***
Total pot $24 | Rake $0.50 
Board [7c Ah 4h]
Seat 1: fightingnuns (button) (small blind) folded on the Flop
Seat 2: donkdonk606 (big blind) collected ($23.50)



PokerStars Game #59777916483:  Hold'em No Limit ($2/$4 USD) - 2011/03/25 12:49:37 ET
Table 'Ambrosia X' 2-max Seat #2 is the button
Seat 1: fightingnuns ($299 in chips) 
Seat 2: donkdonk606 ($636.40 in chips) 
donkdonk606: posts small blind $2
fightingnuns: posts big blind $4
*** HOLE CARDS ***
Dealt to fightingnuns [5d 6s]
donkdonk606: raises $4 to $8
fightingnuns: folds 
Uncalled bet ($4) returned to donkdonk606
donkdonk606 collected $8 from pot
donkdonk606: doesn't show hand 
*** SUMMARY ***
Total pot $8 | Rake $0 
Seat 1: fightingnuns (big blind) folded before Flop
Seat 2: donkdonk606 (button) (small blind) collected ($8)



PokerStars Game #59777922447:  Hold'em No Limit ($2/$4 USD) - 2011/03/25 12:49:45 ET
Table 'Ambrosia X' 2-max Seat #1 is the button
Seat 1: fightingnuns ($295 in chips) 
Seat 2: donkdonk606 ($640.40 in chips) 
fightingnuns: posts small blind $2
donkdonk606: posts big blind $4
*** HOLE CARDS ***
Dealt to fightingnuns [Ts Th]
fightingnuns: raises $8 to $12
donkdonk606: calls $8
*** FLOP *** [7c 5s Qs]
donkdonk606: bets $8
fightingnuns: calls $8
*** TURN *** [7c 5s Qs] [9h]
donkdonk606: bets $20
fightingnuns: calls $20
*** RIVER *** [7c 5s Qs 9h] [Tc]
donkdonk606: bets $16
fightingnuns: raises $64 to $80
donkdonk606: folds 
Uncalled bet ($64) returned to fightingnuns
fightingnuns collected $111.50 from pot
fightingnuns: doesn't show hand 
*** SUMMARY ***
Total pot $112 | Rake $0.50 
Board [7c 5s Qs 9h Tc]
Seat 1: fightingnuns (button) (small blind) collected ($111.50)
Seat 2: donkdonk606 (big blind) folded on the River



PokerStars Game #59777958928:  Hold'em No Limit ($2/$4 USD) - 2011/03/25 12:50:31 ET
Table 'Ambrosia X' 2-max Seat #2 is the button
Seat 1: fightingnuns ($350.50 in chips) 
Seat 2: donkdonk606 ($584.40 in chips) 
donkdonk606: posts small blind $2
fightingnuns: posts big blind $4
*** HOLE CARDS ***
Dealt to fightingnuns [9h 4h]
donkdonk606: raises $4 to $8
fightingnuns: folds 
Uncalled bet ($4) returned to donkdonk606
donkdonk606 collected $8 from pot
donkdonk606: doesn't show hand 
*** SUMMARY ***
Total pot $8 | Rake $0 
Seat 1: fightingnuns (big blind) folded before Flop
Seat 2: donkdonk606 (button) (small blind) collected ($8)



PokerStars Game #59777965454:  Hold'em No Limit ($2/$4 USD) - 2011/03/25 12:50:40 ET
Table 'Ambrosia X' 2-max Seat #1 is the button
Seat 1: fightingnuns ($346.50 in chips) 
Seat 2: donkdonk606 ($588.40 in chips) 
fightingnuns: posts small blind $2
donkdonk606: posts big blind $4
*** HOLE CARDS ***
Dealt to fightingnuns [Kc 4s]
fightingnuns: raises $4 to $8
donkdonk606: calls $4
*** FLOP *** [6c Qd 8d]
donkdonk606: bets $8
fightingnuns: folds 
Uncalled bet ($8) returned to donkdonk606
donkdonk606 collected $15.50 from pot
donkdonk606: doesn't show hand 
*** SUMMARY ***
Total pot $16 | Rake $0.50 
Board [6c Qd 8d]
Seat 1: fightingnuns (button) (small blind) folded on the Flop
Seat 2: donkdonk606 (big blind) collected ($15.50)



PokerStars Game #59777977706:  Hold'em No Limit ($2/$4 USD) - 2011/03/25 12:50:55 ET
Table 'Ambrosia X' 2-max Seat #2 is the button
Seat 1: fightingnuns ($338.50 in chips) 
Seat 2: donkdonk606 ($595.90 in chips) 
donkdonk606: posts small blind $2
fightingnuns: posts big blind $4
*** HOLE CARDS ***
Dealt to fightingnuns [9h 7c]
donkdonk606: folds 
Uncalled bet ($2) returned to fightingnuns
fightingnuns collected $4 from pot
fightingnuns: doesn't show hand 
*** SUMMARY ***
Total pot $4 | Rake $0 
Seat 1: fightingnuns (big blind) collected ($4)
Seat 2: donkdonk606 (button) (small blind) folded before Flop



PokerStars Game #59777982299:  Hold'em No Limit ($2/$4 USD) - 2011/03/25 12:51:01 ET
Table 'Ambrosia X' 2-max Seat #1 is the button
Seat 1: fightingnuns ($340.50 in chips) 
Seat 2: donkdonk606 ($593.90 in chips) 
fightingnuns: posts small blind $2
donkdonk606: posts big blind $4
*** HOLE CARDS ***
Dealt to fightingnuns [Td 3d]
fightingnuns: raises $4 to $8
donkdonk606: calls $4
*** FLOP *** [5c 6d 8h]
donkdonk606: bets $4
fightingnuns: calls $4
*** TURN *** [5c 6d 8h] [9c]
donkdonk606: bets $4
fightingnuns: raises $12 to $16
donkdonk606: folds 
Uncalled bet ($12) returned to fightingnuns
fightingnuns collected $31.50 from pot
fightingnuns: doesn't show hand 
*** SUMMARY ***
Total pot $32 | Rake $0.50 
Board [5c 6d 8h 9c]
Seat 1: fightingnuns (button) (small blind) collected ($31.50)
Seat 2: donkdonk606 (big blind) folded on the Turn



PokerStars Game #59778003641:  Hold'em No Limit ($2/$4 USD) - 2011/03/25 12:51:28 ET
Table 'Ambrosia X' 2-max Seat #2 is the button
Seat 1: fightingnuns ($356 in chips) 
Seat 2: donkdonk606 ($577.90 in chips) 
donkdonk606: posts small blind $2
fightingnuns: posts big blind $4
*** HOLE CARDS ***
Dealt to fightingnuns [2c Kh]
donkdonk606: raises $4 to $8
fightingnuns: folds 
Uncalled bet ($4) returned to donkdonk606
donkdonk606 collected $8 from pot
donkdonk606: doesn't show hand 
*** SUMMARY ***
Total pot $8 | Rake $0 
Seat 1: fightingnuns (big blind) folded before Flop
Seat 2: donkdonk606 (button) (small blind) collected ($8)



PokerStars Game #59778009374:  Hold'em No Limit ($2/$4 USD) - 2011/03/25 12:51:35 ET
Table 'Ambrosia X' 2-max Seat #1 is the button
Seat 1: fightingnuns ($352 in chips) 
Seat 2: donkdonk606 ($581.90 in chips) 
fightingnuns: posts small blind $2
donkdonk606: posts big blind $4
*** HOLE CARDS ***
Dealt to fightingnuns [8d Qc]
fightingnuns: raises $4 to $8
donkdonk606: calls $4
*** FLOP *** [5s 8s Jc]
donkdonk606: bets $8
fightingnuns: calls $8
*** TURN *** [5s 8s Jc] [2s]
donkdonk606: bets $16
fightingnuns: calls $16
*** RIVER *** [5s 8s Jc 2s] [Tc]
donkdonk606: checks 
fightingnuns: checks 
*** SHOW DOWN ***
donkdonk606: shows [6d 6s] (a pair of Sixes)
fightingnuns: shows [8d Qc] (a pair of Eights)
fightingnuns collected $63.50 from pot
*** SUMMARY ***
Total pot $64 | Rake $0.50 
Board [5s 8s Jc 2s Tc]
Seat 1: fightingnuns (button) (small blind) showed [8d Qc] and won ($63.50) with a pair of Eights
Seat 2: donkdonk606 (big blind) showed [6d 6s] and lost with a pair of Sixes



PokerStars Game #59778036711:  Hold'em No Limit ($2/$4 USD) - 2011/03/25 12:52:10 ET
Table 'Ambrosia X' 2-max Seat #2 is the button
Seat 1: fightingnuns ($383.50 in chips) 
Seat 2: donkdonk606 ($549.90 in chips) 
donkdonk606: posts small blind $2
fightingnuns: posts big blind $4
*** HOLE CARDS ***
Dealt to fightingnuns [Js Th]
donkdonk606: raises $4 to $8
fightingnuns: calls $4
*** FLOP *** [Kd 6d 6s]
fightingnuns: checks 
donkdonk606: checks 
*** TURN *** [Kd 6d 6s] [Qs]
fightingnuns: bets $8
donkdonk606: folds 
Uncalled bet ($8) returned to fightingnuns
fightingnuns collected $15.50 from pot
fightingnuns: doesn't show hand 
*** SUMMARY ***
Total pot $16 | Rake $0.50 
Board [Kd 6d 6s Qs]
Seat 1: fightingnuns (big blind) collected ($15.50)
Seat 2: donkdonk606 (button) (small blind) folded on the Turn



PokerStars Game #59778051137:  Hold'em No Limit ($2/$4 USD) - 2011/03/25 12:52:29 ET
Table 'Ambrosia X' 2-max Seat #1 is the button
Seat 1: fightingnuns ($391 in chips) 
Seat 2: donkdonk606 ($541.90 in chips) 
fightingnuns: posts small blind $2
donkdonk606: posts big blind $4
*** HOLE CARDS ***
Dealt to fightingnuns [Kc 2c]
fightingnuns: raises $4 to $8
donkdonk606: folds 
Uncalled bet ($4) returned to fightingnuns
fightingnuns collected $8 from pot
fightingnuns: doesn't show hand 
*** SUMMARY ***
Total pot $8 | Rake $0 
Seat 1: fightingnuns (button) (small blind) collected ($8)
Seat 2: donkdonk606 (big blind) folded before Flop



PokerStars Game #59778056888:  Hold'em No Limit ($2/$4 USD) - 2011/03/25 12:52:36 ET
Table 'Ambrosia X' 2-max Seat #2 is the button
Seat 1: fightingnuns ($395 in chips) 
Seat 2: donkdonk606 ($537.90 in chips) 
donkdonk606: posts small blind $2
fightingnuns: posts big blind $4
*** HOLE CARDS ***
Dealt to fightingnuns [Qs 7h]
donkdonk606: raises $4 to $8
fightingnuns: folds 
Uncalled bet ($4) returned to donkdonk606
donkdonk606 collected $8 from pot
donkdonk606: doesn't show hand 
*** SUMMARY ***
Total pot $8 | Rake $0 
Seat 1: fightingnuns (big blind) folded before Flop
Seat 2: donkdonk606 (button) (small blind) collected ($8)



PokerStars Game #59778064116:  Hold'em No Limit ($2/$4 USD) - 2011/03/25 12:52:45 ET
Table 'Ambrosia X' 2-max Seat #1 is the button
Seat 1: fightingnuns ($391 in chips) 
Seat 2: donkdonk606 ($541.90 in chips) 
fightingnuns: posts small blind $2
donkdonk606: posts big blind $4
*** HOLE CARDS ***
Dealt to fightingnuns [2c Ts]
fightingnuns: folds 
Uncalled bet ($2) returned to donkdonk606
donkdonk606 collected $4 from pot
donkdonk606: doesn't show hand 
*** SUMMARY ***
Total pot $4 | Rake $0 
Seat 1: fightingnuns (button) (small blind) folded before Flop
Seat 2: donkdonk606 (big blind) collected ($4)



PokerStars Game #59778068394:  Hold'em No Limit ($2/$4 USD) - 2011/03/25 12:52:50 ET
Table 'Ambrosia X' 2-max Seat #2 is the button
Seat 1: fightingnuns ($389 in chips) 
Seat 2: donkdonk606 ($543.90 in chips) 
donkdonk606: posts small blind $2
fightingnuns: posts big blind $4
*** HOLE CARDS ***
Dealt to fightingnuns [6h Qd]
donkdonk606: raises $4 to $8
fightingnuns: folds 
Uncalled bet ($4) returned to donkdonk606
donkdonk606 collected $8 from pot
donkdonk606: doesn't show hand 
*** SUMMARY ***
Total pot $8 | Rake $0 
Seat 1: fightingnuns (big blind) folded before Flop
Seat 2: donkdonk606 (button) (small blind) collected ($8)



PokerStars Game #59778074099:  Hold'em No Limit ($2/$4 USD) - 2011/03/25 12:52:58 ET
Table 'Ambrosia X' 2-max Seat #1 is the button
Seat 1: fightingnuns ($385 in chips) 
Seat 2: donkdonk606 ($547.90 in chips) 
fightingnuns: posts small blind $2
donkdonk606: posts big blind $4
*** HOLE CARDS ***
Dealt to fightingnuns [As Td]
fightingnuns: raises $4 to $8
donkdonk606: raises $4 to $12
fightingnuns: calls $4
*** FLOP *** [Ad 8s 5s]
donkdonk606: bets $4
fightingnuns: raises $12 to $16
donkdonk606: folds 
Uncalled bet ($12) returned to fightingnuns
fightingnuns collected $31.50 from pot
fightingnuns: doesn't show hand 
*** SUMMARY ***
Total pot $32 | Rake $0.50 
Board [Ad 8s 5s]
Seat 1: fightingnuns (button) (small blind) collected ($31.50)
Seat 2: donkdonk606 (big blind) folded on the Flop



PokerStars Game #59778092807:  Hold'em No Limit ($2/$4 USD) - 2011/03/25 12:53:21 ET
Table 'Ambrosia X' 2-max Seat #2 is the button
Seat 1: fightingnuns ($400.50 in chips) 
Seat 2: donkdonk606 ($531.90 in chips) 
donkdonk606: posts small blind $2
fightingnuns: posts big blind $4
*** HOLE CARDS ***
Dealt to fightingnuns [Ac 7c]
donkdonk606: folds 
Uncalled bet ($2) returned to fightingnuns
fightingnuns collected $4 from pot
fightingnuns: doesn't show hand 
*** SUMMARY ***
Total pot $4 | Rake $0 
Seat 1: fightingnuns (big blind) collected ($4)
Seat 2: donkdonk606 (button) (small blind) folded before Flop



PokerStars Game #59778099161:  Hold'em No Limit ($2/$4 USD) - 2011/03/25 12:53:29 ET
Table 'Ambrosia X' 2-max Seat #1 is the button
Seat 1: fightingnuns ($402.50 in chips) 
Seat 2: donkdonk606 ($529.90 in chips) 
fightingnuns: posts small blind $2
donkdonk606: posts big blind $4
*** HOLE CARDS ***
Dealt to fightingnuns [Ad 9h]
fightingnuns: raises $4 to $8
donkdonk606: raises $8 to $16
fightingnuns: calls $8
*** FLOP *** [5d 4d 7s]
donkdonk606: checks 
fightingnuns: checks 
*** TURN *** [5d 4d 7s] [3h]
donkdonk606: bets $8
fightingnuns: folds 
Uncalled bet ($8) returned to donkdonk606
donkdonk606 collected $31.50 from pot
donkdonk606: doesn't show hand 
*** SUMMARY ***
Total pot $32 | Rake $0.50 
Board [5d 4d 7s 3h]
Seat 1: fightingnuns (button) (small blind) folded on the Turn
Seat 2: donkdonk606 (big blind) collected ($31.50)



PokerStars Game #59778125156:  Hold'em No Limit ($2/$4 USD) - 2011/03/25 12:54:02 ET
Table 'Ambrosia X' 2-max Seat #2 is the button
Seat 1: fightingnuns ($386.50 in chips) 
Seat 2: donkdonk606 ($545.40 in chips) 
donkdonk606: posts small blind $2
fightingnuns: posts big blind $4
*** HOLE CARDS ***
Dealt to fightingnuns [8c 2s]
donkdonk606: folds 
Uncalled bet ($2) returned to fightingnuns
fightingnuns collected $4 from pot
fightingnuns: doesn't show hand 
*** SUMMARY ***
Total pot $4 | Rake $0 
Seat 1: fightingnuns (big blind) collected ($4)
Seat 2: donkdonk606 (button) (small blind) folded before Flop



PokerStars Game #59778128979:  Hold'em No Limit ($2/$4 USD) - 2011/03/25 12:54:07 ET
Table 'Ambrosia X' 2-max Seat #1 is the button
Seat 1: fightingnuns ($388.50 in chips) 
Seat 2: donkdonk606 ($543.40 in chips) 
fightingnuns: posts small blind $2
donkdonk606: posts big blind $4
*** HOLE CARDS ***
Dealt to fightingnuns [4c As]
fightingnuns: raises $4 to $8
donkdonk606: calls $4
*** FLOP *** [4d Td 3c]
donkdonk606: bets $8
fightingnuns: calls $8
*** TURN *** [4d Td 3c] [Qc]
donkdonk606: checks 
fightingnuns: checks 
*** RIVER *** [4d Td 3c Qc] [4h]
donkdonk606: checks 
fightingnuns: bets $55
donkdonk606: folds 
Uncalled bet ($55) returned to fightingnuns
fightingnuns collected $31.50 from pot
fightingnuns: doesn't show hand 
*** SUMMARY ***
Total pot $32 | Rake $0.50 
Board [4d Td 3c Qc 4h]
Seat 1: fightingnuns (button) (small blind) collected ($31.50)
Seat 2: donkdonk606 (big blind) folded on the River



PokerStars Game #59778164031:  Hold'em No Limit ($2/$4 USD) - 2011/03/25 12:54:51 ET
Table 'Ambrosia X' 2-max Seat #2 is the button
Seat 1: fightingnuns ($404 in chips) 
Seat 2: donkdonk606 ($527.40 in chips) 
donkdonk606: posts small blind $2
fightingnuns: posts big blind $4
*** HOLE CARDS ***
Dealt to fightingnuns [Js 7h]
donkdonk606: raises $4 to $8
fightingnuns: folds 
Uncalled bet ($4) returned to donkdonk606
donkdonk606 collected $8 from pot
donkdonk606: doesn't show hand 
*** SUMMARY ***
Total pot $8 | Rake $0 
Seat 1: fightingnuns (big blind) folded before Flop
Seat 2: donkdonk606 (button) (small blind) collected ($8)



PokerStars Game #59778170617:  Hold'em No Limit ($2/$4 USD) - 2011/03/25 12:55:00 ET
Table 'Ambrosia X' 2-max Seat #1 is the button
Seat 1: fightingnuns ($400 in chips) 
Seat 2: donkdonk606 ($531.40 in chips) 
fightingnuns: posts small blind $2
donkdonk606: posts big blind $4
*** HOLE CARDS ***
Dealt to fightingnuns [3h Qd]
fightingnuns: folds 
Uncalled bet ($2) returned to donkdonk606
donkdonk606 collected $4 from pot
donkdonk606: doesn't show hand 
*** SUMMARY ***
Total pot $4 | Rake $0 
Seat 1: fightingnuns (button) (small blind) folded before Flop
Seat 2: donkdonk606 (big blind) collected ($4)



PokerStars Game #59778175245:  Hold'em No Limit ($2/$4 USD) - 2011/03/25 12:55:06 ET
Table 'Ambrosia X' 2-max Seat #2 is the button
Seat 1: fightingnuns ($398 in chips) 
Seat 2: donkdonk606 ($533.40 in chips) 
donkdonk606: posts small blind $2
fightingnuns: posts big blind $4
*** HOLE CARDS ***
Dealt to fightingnuns [3s 6c]
donkdonk606: raises $4 to $8
fightingnuns: folds 
Uncalled bet ($4) returned to donkdonk606
donkdonk606 collected $8 from pot
donkdonk606: doesn't show hand 
*** SUMMARY ***
Total pot $8 | Rake $0 
Seat 1: fightingnuns (big blind) folded before Flop
Seat 2: donkdonk606 (button) (small blind) collected ($8)



PokerStars Game #59778181256:  Hold'em No Limit ($2/$4 USD) - 2011/03/25 12:55:14 ET
Table 'Ambrosia X' 2-max Seat #1 is the button
Seat 1: fightingnuns ($394 in chips) 
Seat 2: donkdonk606 ($537.40 in chips) 
fightingnuns: posts small blind $2
donkdonk606: posts big blind $4
*** HOLE CARDS ***
Dealt to fightingnuns [Ad 4d]
fightingnuns: raises $4 to $8
donkdonk606: calls $4
*** FLOP *** [Kc Kd Td]
donkdonk606: bets $4
fightingnuns: raises $12 to $16
donkdonk606: calls $12
*** TURN *** [Kc Kd Td] [Qd]
donkdonk606: bets $44
fightingnuns: raises $80 to $124
donkdonk606: raises $389.40 to $513.40 and is all-in
fightingnuns: calls $246 and is all-in
Uncalled bet ($143.40) returned to donkdonk606
*** RIVER *** [Kc Kd Td Qd] [As]
*** SHOW DOWN ***
donkdonk606: shows [Jd 3d] (a flush, King high)
fightingnuns: shows [Ad 4d] (a flush, Ace high)
fightingnuns collected $787.50 from pot
*** SUMMARY ***
Total pot $788 | Rake $0.50 
Board [Kc Kd Td Qd As]
Seat 1: fightingnuns (button) (small blind) showed [Ad 4d] and won ($787.50) with a flush, Ace high
Seat 2: donkdonk606 (big blind) showed [Jd 3d] and lost with a flush, King high



PokerStars Game #59778208555:  Hold'em No Limit ($2/$4 USD) - 2011/03/25 12:55:56 ET
Table 'Ambrosia X' 2-max Seat #2 is the button
Seat 1: fightingnuns ($787.50 in chips) 
Seat 2: donkdonk606 ($143.40 in chips) 
donkdonk606: posts small blind $2
fightingnuns: posts big blind $4
*** HOLE CARDS ***
Dealt to fightingnuns [7h 3d]
donkdonk606: folds 
Uncalled bet ($2) returned to fightingnuns
fightingnuns collected $4 from pot
fightingnuns: doesn't show hand 
*** SUMMARY ***
Total pot $4 | Rake $0 
Seat 1: fightingnuns (big blind) collected ($4)
Seat 2: donkdonk606 (button) (small blind) folded before Flop



PokerStars Game #59778212200:  Hold'em No Limit ($2/$4 USD) - 2011/03/25 12:56:02 ET
Table 'Ambrosia X' 2-max Seat #1 is the button
Seat 1: fightingnuns ($789.50 in chips) 
Seat 2: donkdonk606 ($141.40 in chips) 
fightingnuns: posts small blind $2
donkdonk606: posts big blind $4
*** HOLE CARDS ***
Dealt to fightingnuns [Ad Ts]
fightingnuns: raises $8 to $12
donkdonk606: calls $8
*** FLOP *** [9d Th Kh]
donkdonk606: bets $8
fightingnuns: calls $8
*** TURN *** [9d Th Kh] [7s]
donkdonk606: bets $16
fightingnuns: calls $16
*** RIVER *** [9d Th Kh 7s] [6c]
donkdonk606: bets $16
fightingnuns: calls $16
*** SHOW DOWN ***
donkdonk606: shows [7h Qh] (a pair of Sevens)
fightingnuns: shows [Ad Ts] (a pair of Tens)
fightingnuns collected $103.50 from pot
*** SUMMARY ***
Total pot $104 | Rake $0.50 
Board [9d Th Kh 7s 6c]
Seat 1: fightingnuns (button) (small blind) showed [Ad Ts] and won ($103.50) with a pair of Tens
Seat 2: donkdonk606 (big blind) showed [7h Qh] and lost with a pair of Sevens



PokerStars Game #59778235395:  Hold'em No Limit ($2/$4 USD) - 2011/03/25 12:56:38 ET
Table 'Ambrosia X' 2-max Seat #2 is the button
Seat 1: fightingnuns ($841 in chips) 
Seat 2: donkdonk606 ($89.40 in chips) 
donkdonk606: posts small blind $2
fightingnuns: posts big blind $4
*** HOLE CARDS ***
Dealt to fightingnuns [8s 8h]
donkdonk606: raises $8 to $12
fightingnuns: raises $376 to $388
donkdonk606: calls $77.40 and is all-in
Uncalled bet ($298.60) returned to fightingnuns
*** FLOP *** [Ks 5d 8d]
*** TURN *** [Ks 5d 8d] [Kd]
*** RIVER *** [Ks 5d 8d Kd] [6c]
*** SHOW DOWN ***
fightingnuns: shows [8s 8h] (a full house, Eights full of Kings)
donkdonk606: shows [Jc Qc] (a pair of Kings)
fightingnuns collected $178.30 from pot
*** SUMMARY ***
Total pot $178.80 | Rake $0.50 
Board [Ks 5d 8d Kd 6c]
Seat 1: fightingnuns (big blind) showed [8s 8h] and won ($178.30) with a full house, Eights full of Kings
Seat 2: donkdonk606 (button) (small blind) showed [Jc Qc] and lost with a pair of Kings



PokerStars Game #59725893200:  Hold'em No Limit ($2/$4 USD) - 2011/03/24 13:48:32 ET
Table 'Thekla IX' 2-max Seat #2 is the button
Seat 1: fightingnuns ($200 in chips) 
Seat 2: davidb1962 ($187.20 in chips) 
davidb1962: posts small blind $2
fightingnuns: posts big blind $4
*** HOLE CARDS ***
Dealt to fightingnuns [Js Jh]
davidb1962: folds 
Uncalled bet ($2) returned to fightingnuns
fightingnuns collected $4 from pot
fightingnuns: doesn't show hand 
*** SUMMARY ***
Total pot $4 | Rake $0 
Seat 1: fightingnuns (big blind) collected ($4)
Seat 2: davidb1962 (button) (small blind) folded before Flop



PokerStars Game #59725898936:  Hold'em No Limit ($2/$4 USD) - 2011/03/24 13:48:39 ET
Table 'Thekla IX' 2-max Seat #1 is the button
Seat 1: fightingnuns ($202 in chips) 
Seat 2: davidb1962 ($185.20 in chips) 
fightingnuns: posts small blind $2
davidb1962: posts big blind $4
*** HOLE CARDS ***
Dealt to fightingnuns [7d 8c]
fightingnuns: raises $8 to $12
davidb1962: calls $8
*** FLOP *** [Jd 6d 6h]
davidb1962: checks 
fightingnuns: checks 
*** TURN *** [Jd 6d 6h] [5d]
davidb1962: checks 
fightingnuns: bets $16
davidb1962: folds 
Uncalled bet ($16) returned to fightingnuns
fightingnuns collected $23.50 from pot
fightingnuns: doesn't show hand 
*** SUMMARY ***
Total pot $24 | Rake $0.50 
Board [Jd 6d 6h 5d]
Seat 1: fightingnuns (button) (small blind) collected ($23.50)
Seat 2: davidb1962 (big blind) folded on the Turn



PokerStars Game #59725924069:  Hold'em No Limit ($2/$4 USD) - 2011/03/24 13:49:06 ET
Table 'Thekla IX' 2-max Seat #2 is the button
Seat 1: fightingnuns ($213.50 in chips) 
Seat 2: davidb1962 ($173.20 in chips) 
davidb1962: posts small blind $2
fightingnuns: posts big blind $4
*** HOLE CARDS ***
Dealt to fightingnuns [Qs 3h]
davidb1962: folds 
Uncalled bet ($2) returned to fightingnuns
fightingnuns collected $4 from pot
fightingnuns: doesn't show hand 
*** SUMMARY ***
Total pot $4 | Rake $0 
Seat 1: fightingnuns (big blind) collected ($4)
Seat 2: davidb1962 (button) (small blind) folded before Flop



PokerStars Game #59725929283:  Hold'em No Limit ($2/$4 USD) - 2011/03/24 13:49:12 ET
Table 'Thekla IX' 2-max Seat #1 is the button
Seat 1: fightingnuns ($215.50 in chips) 
Seat 2: davidb1962 ($171.20 in chips) 
fightingnuns: posts small blind $2
davidb1962: posts big blind $4
*** HOLE CARDS ***
Dealt to fightingnuns [2d 4d]
fightingnuns: raises $4 to $8
davidb1962: folds 
Uncalled bet ($4) returned to fightingnuns
fightingnuns collected $8 from pot
fightingnuns: doesn't show hand 
*** SUMMARY ***
Total pot $8 | Rake $0 
Seat 1: fightingnuns (button) (small blind) collected ($8)
Seat 2: davidb1962 (big blind) folded before Flop



PokerStars Game #59725936469:  Hold'em No Limit ($2/$4 USD) - 2011/03/24 13:49:20 ET
Table 'Thekla IX' 2-max Seat #2 is the button
Seat 1: fightingnuns ($219.50 in chips) 
Seat 2: davidb1962 ($167.20 in chips) 
davidb1962: posts small blind $2
fightingnuns: posts big blind $4
*** HOLE CARDS ***
Dealt to fightingnuns [8h 5s]
davidb1962: raises $4 to $8
fightingnuns: folds 
Uncalled bet ($4) returned to davidb1962
davidb1962 collected $8 from pot
*** SUMMARY ***
Total pot $8 | Rake $0 
Seat 1: fightingnuns (big blind) folded before Flop
Seat 2: davidb1962 (button) (small blind) collected ($8)



PokerStars Game #59725943992:  Hold'em No Limit ($2/$4 USD) - 2011/03/24 13:49:29 ET
Table 'Thekla IX' 2-max Seat #1 is the button
Seat 1: fightingnuns ($215.50 in chips) 
Seat 2: davidb1962 ($171.20 in chips) 
fightingnuns: posts small blind $2
davidb1962: posts big blind $4
*** HOLE CARDS ***
Dealt to fightingnuns [8s 6c]
fightingnuns: raises $4 to $8
davidb1962: calls $4
*** FLOP *** [Td 5d 9c]
davidb1962: bets $16
fightingnuns: raises $20 to $36
davidb1962: folds 
Uncalled bet ($20) returned to fightingnuns
fightingnuns collected $47.50 from pot
fightingnuns: doesn't show hand 
*** SUMMARY ***
Total pot $48 | Rake $0.50 
Board [Td 5d 9c]
Seat 1: fightingnuns (button) (small blind) collected ($47.50)
Seat 2: davidb1962 (big blind) folded on the Flop



PokerStars Game #59725963317:  Hold'em No Limit ($2/$4 USD) - 2011/03/24 13:49:50 ET
Table 'Thekla IX' 2-max Seat #2 is the button
Seat 1: fightingnuns ($239 in chips) 
Seat 2: davidb1962 ($147.20 in chips) 
davidb1962: posts small blind $2
fightingnuns: posts big blind $4
*** HOLE CARDS ***
Dealt to fightingnuns [3s Tc]
davidb1962: folds 
Uncalled bet ($2) returned to fightingnuns
fightingnuns collected $4 from pot
fightingnuns: doesn't show hand 
*** SUMMARY ***
Total pot $4 | Rake $0 
Seat 1: fightingnuns (big blind) collected ($4)
Seat 2: davidb1962 (button) (small blind) folded before Flop



PokerStars Game #59725968403:  Hold'em No Limit ($2/$4 USD) - 2011/03/24 13:49:55 ET
Table 'Thekla IX' 2-max Seat #1 is the button
Seat 1: fightingnuns ($241 in chips) 
Seat 2: davidb1962 ($145.20 in chips) 
fightingnuns: posts small blind $2
davidb1962: posts big blind $4
*** HOLE CARDS ***
Dealt to fightingnuns [Jd 5h]
fightingnuns: raises $4 to $8
davidb1962: calls $4
*** FLOP *** [7h 4d Qc]
davidb1962: checks 
fightingnuns: bets $12
davidb1962: calls $12
*** TURN *** [7h 4d Qc] [9d]
davidb1962: checks 
fightingnuns: checks 
*** RIVER *** [7h 4d Qc 9d] [Ad]
davidb1962: bets $24
fightingnuns: folds 
Uncalled bet ($24) returned to davidb1962
davidb1962 collected $39.50 from pot
*** SUMMARY ***
Total pot $40 | Rake $0.50 
Board [7h 4d Qc 9d Ad]
Seat 1: fightingnuns (button) (small blind) folded on the River
Seat 2: davidb1962 (big blind) collected ($39.50)



PokerStars Game #59726012792:  Hold'em No Limit ($2/$4 USD) - 2011/03/24 13:50:44 ET
Table 'Thekla IX' 2-max Seat #2 is the button
Seat 1: fightingnuns ($221 in chips) 
Seat 2: davidb1962 ($164.70 in chips) 
davidb1962: posts small blind $2
fightingnuns: posts big blind $4
*** HOLE CARDS ***
Dealt to fightingnuns [Tc Ad]
davidb1962: raises $4 to $8
fightingnuns: calls $4
*** FLOP *** [Ah 8c 8d]
fightingnuns: checks 
davidb1962: checks 
*** TURN *** [Ah 8c 8d] [7d]
fightingnuns: bets $12
davidb1962: calls $12
*** RIVER *** [Ah 8c 8d 7d] [4s]
fightingnuns: checks 
davidb1962: checks 
*** SHOW DOWN ***
fightingnuns: shows [Tc Ad] (two pair, Aces and Eights)
davidb1962: mucks hand 
fightingnuns collected $39.50 from pot
*** SUMMARY ***
Total pot $40 | Rake $0.50 
Board [Ah 8c 8d 7d 4s]
Seat 1: fightingnuns (big blind) showed [Tc Ad] and won ($39.50) with two pair, Aces and Eights
Seat 2: davidb1962 (button) (small blind) mucked [9d Td]



PokerStars Game #59726038794:  Hold'em No Limit ($2/$4 USD) - 2011/03/24 13:51:13 ET
Table 'Thekla IX' 2-max Seat #1 is the button
Seat 1: fightingnuns ($240.50 in chips) 
Seat 2: davidb1962 ($144.70 in chips) 
fightingnuns: posts small blind $2
davidb1962: posts big blind $4
*** HOLE CARDS ***
Dealt to fightingnuns [5h 8h]
fightingnuns: raises $4 to $8
davidb1962: folds 
Uncalled bet ($4) returned to fightingnuns
fightingnuns collected $8 from pot
fightingnuns: doesn't show hand 
*** SUMMARY ***
Total pot $8 | Rake $0 
Seat 1: fightingnuns (button) (small blind) collected ($8)
Seat 2: davidb1962 (big blind) folded before Flop



PokerStars Game #59726046937:  Hold'em No Limit ($2/$4 USD) - 2011/03/24 13:51:22 ET
Table 'Thekla IX' 2-max Seat #2 is the button
Seat 1: fightingnuns ($244.50 in chips) 
Seat 2: davidb1962 ($140.70 in chips) 
davidb1962: posts small blind $2
fightingnuns: posts big blind $4
*** HOLE CARDS ***
Dealt to fightingnuns [Qd 3d]
davidb1962: raises $4 to $8
fightingnuns: folds 
Uncalled bet ($4) returned to davidb1962
davidb1962 collected $8 from pot
*** SUMMARY ***
Total pot $8 | Rake $0 
Seat 1: fightingnuns (big blind) folded before Flop
Seat 2: davidb1962 (button) (small blind) collected ($8)



PokerStars Game #59726055833:  Hold'em No Limit ($2/$4 USD) - 2011/03/24 13:51:32 ET
Table 'Thekla IX' 2-max Seat #1 is the button
Seat 1: fightingnuns ($240.50 in chips) 
Seat 2: davidb1962 ($144.70 in chips) 
fightingnuns: posts small blind $2
davidb1962: posts big blind $4
*** HOLE CARDS ***
Dealt to fightingnuns [8d Qd]
fightingnuns: raises $4 to $8
davidb1962: folds 
Uncalled bet ($4) returned to fightingnuns
fightingnuns collected $8 from pot
fightingnuns: doesn't show hand 
*** SUMMARY ***
Total pot $8 | Rake $0 
Seat 1: fightingnuns (button) (small blind) collected ($8)
Seat 2: davidb1962 (big blind) folded before Flop



PokerStars Game #59726063690:  Hold'em No Limit ($2/$4 USD) - 2011/03/24 13:51:41 ET
Table 'Thekla IX' 2-max Seat #2 is the button
Seat 1: fightingnuns ($244.50 in chips) 
Seat 2: davidb1962 ($140.70 in chips) 
davidb1962: posts small blind $2
fightingnuns: posts big blind $4
*** HOLE CARDS ***
Dealt to fightingnuns [8h Qd]
davidb1962: folds 
Uncalled bet ($2) returned to fightingnuns
fightingnuns collected $4 from pot
fightingnuns: doesn't show hand 
*** SUMMARY ***
Total pot $4 | Rake $0 
Seat 1: fightingnuns (big blind) collected ($4)
Seat 2: davidb1962 (button) (small blind) folded before Flop



PokerStars Game #59726068797:  Hold'em No Limit ($2/$4 USD) - 2011/03/24 13:51:46 ET
Table 'Thekla IX' 2-max Seat #1 is the button
Seat 1: fightingnuns ($246.50 in chips) 
Seat 2: davidb1962 ($138.70 in chips) 
fightingnuns: posts small blind $2
davidb1962: posts big blind $4
*** HOLE CARDS ***
Dealt to fightingnuns [Kh Tc]
fightingnuns: raises $4 to $8
davidb1962: raises $16 to $24
fightingnuns: folds 
Uncalled bet ($16) returned to davidb1962
davidb1962 collected $16 from pot
*** SUMMARY ***
Total pot $16 | Rake $0 
Seat 1: fightingnuns (button) (small blind) folded before Flop
Seat 2: davidb1962 (big blind) collected ($16)



PokerStars Game #59726080582:  Hold'em No Limit ($2/$4 USD) - 2011/03/24 13:51:59 ET
Table 'Thekla IX' 2-max Seat #2 is the button
Seat 1: fightingnuns ($238.50 in chips) 
Seat 2: davidb1962 ($146.70 in chips) 
davidb1962: posts small blind $2
fightingnuns: posts big blind $4
*** HOLE CARDS ***
Dealt to fightingnuns [3d 6c]
davidb1962: raises $4 to $8
fightingnuns: folds 
Uncalled bet ($4) returned to davidb1962
davidb1962 collected $8 from pot
*** SUMMARY ***
Total pot $8 | Rake $0 
Seat 1: fightingnuns (big blind) folded before Flop
Seat 2: davidb1962 (button) (small blind) collected ($8)



PokerStars Game #59726088353:  Hold'em No Limit ($2/$4 USD) - 2011/03/24 13:52:08 ET
Table 'Thekla IX' 2-max Seat #1 is the button
Seat 1: fightingnuns ($234.50 in chips) 
Seat 2: davidb1962 ($150.70 in chips) 
fightingnuns: posts small blind $2
davidb1962: posts big blind $4
*** HOLE CARDS ***
Dealt to fightingnuns [5d Ah]
fightingnuns: raises $4 to $8
davidb1962: calls $4
*** FLOP *** [7d 8s 9s]
davidb1962: checks 
fightingnuns: checks 
*** TURN *** [7d 8s 9s] [As]
davidb1962: checks 
fightingnuns: bets $12
davidb1962: calls $12
*** RIVER *** [7d 8s 9s As] [Qd]
davidb1962: checks 
fightingnuns: checks 
*** SHOW DOWN ***
davidb1962: shows [Jc 9h] (a pair of Nines)
fightingnuns: shows [5d Ah] (a pair of Aces)
fightingnuns collected $39.50 from pot
*** SUMMARY ***
Total pot $40 | Rake $0.50 
Board [7d 8s 9s As Qd]
Seat 1: fightingnuns (button) (small blind) showed [5d Ah] and won ($39.50) with a pair of Aces
Seat 2: davidb1962 (big blind) showed [Jc 9h] and lost with a pair of Nines



PokerStars Game #59726114661:  Hold'em No Limit ($2/$4 USD) - 2011/03/24 13:52:37 ET
Table 'Thekla IX' 2-max Seat #2 is the button
Seat 1: fightingnuns ($254 in chips) 
Seat 2: davidb1962 ($130.70 in chips) 
davidb1962: posts small blind $2
fightingnuns: posts big blind $4
*** HOLE CARDS ***
Dealt to fightingnuns [9s Kd]
davidb1962: folds 
Uncalled bet ($2) returned to fightingnuns
fightingnuns collected $4 from pot
fightingnuns: doesn't show hand 
*** SUMMARY ***
Total pot $4 | Rake $0 
Seat 1: fightingnuns (big blind) collected ($4)
Seat 2: davidb1962 (button) (small blind) folded before Flop



PokerStars Game #59726119773:  Hold'em No Limit ($2/$4 USD) - 2011/03/24 13:52:43 ET
Table 'Thekla IX' 2-max Seat #1 is the button
Seat 1: fightingnuns ($256 in chips) 
Seat 2: davidb1962 ($128.70 in chips) 
fightingnuns: posts small blind $2
davidb1962: posts big blind $4
*** HOLE CARDS ***
Dealt to fightingnuns [Th 9d]
fightingnuns: raises $4 to $8
davidb1962: folds 
Uncalled bet ($4) returned to fightingnuns
fightingnuns collected $8 from pot
fightingnuns: doesn't show hand 
*** SUMMARY ***
Total pot $8 | Rake $0 
Seat 1: fightingnuns (button) (small blind) collected ($8)
Seat 2: davidb1962 (big blind) folded before Flop



PokerStars Game #59726126666:  Hold'em No Limit ($2/$4 USD) - 2011/03/24 13:52:50 ET
Table 'Thekla IX' 2-max Seat #2 is the button
Seat 1: fightingnuns ($260 in chips) 
Seat 2: davidb1962 ($124.70 in chips) 
davidb1962: posts small blind $2
fightingnuns: posts big blind $4
*** HOLE CARDS ***
Dealt to fightingnuns [Jd Ah]
davidb1962: raises $8 to $12
fightingnuns: raises $24 to $36
davidb1962: calls $24
*** FLOP *** [5d 3h 6d]
fightingnuns: checks 
davidb1962: checks 
*** TURN *** [5d 3h 6d] [Ks]
fightingnuns: bets $224 and is all-in
davidb1962: folds 
Uncalled bet ($224) returned to fightingnuns
fightingnuns collected $71.50 from pot
fightingnuns: doesn't show hand 
*** SUMMARY ***
Total pot $72 | Rake $0.50 
Board [5d 3h 6d Ks]
Seat 1: fightingnuns (big blind) collected ($71.50)
Seat 2: davidb1962 (button) (small blind) folded on the Turn



PokerStars Game #59726157699:  Hold'em No Limit ($2/$4 USD) - 2011/03/24 13:53:25 ET
Table 'Thekla IX' 2-max Seat #1 is the button
Seat 1: fightingnuns ($295.50 in chips) 
Seat 2: davidb1962 ($88.70 in chips) 
fightingnuns: posts small blind $2
davidb1962: posts big blind $4
*** HOLE CARDS ***
Dealt to fightingnuns [Jd 5c]
fightingnuns: folds 
Uncalled bet ($2) returned to davidb1962
davidb1962 collected $4 from pot
*** SUMMARY ***
Total pot $4 | Rake $0 
Seat 1: fightingnuns (button) (small blind) folded before Flop
Seat 2: davidb1962 (big blind) collected ($4)



PokerStars Game #59726163577:  Hold'em No Limit ($2/$4 USD) - 2011/03/24 13:53:31 ET
Table 'Thekla IX' 2-max Seat #2 is the button
Seat 1: fightingnuns ($293.50 in chips) 
Seat 2: davidb1962 ($90.70 in chips) 
davidb1962: posts small blind $2
fightingnuns: posts big blind $4
*** HOLE CARDS ***
Dealt to fightingnuns [6c 9d]
davidb1962: raises $4 to $8
fightingnuns: folds 
Uncalled bet ($4) returned to davidb1962
davidb1962 collected $8 from pot
*** SUMMARY ***
Total pot $8 | Rake $0 
Seat 1: fightingnuns (big blind) folded before Flop
Seat 2: davidb1962 (button) (small blind) collected ($8)



PokerStars Game #59726170145:  Hold'em No Limit ($2/$4 USD) - 2011/03/24 13:53:39 ET
Table 'Thekla IX' 2-max Seat #1 is the button
Seat 1: fightingnuns ($289.50 in chips) 
Seat 2: davidb1962 ($94.70 in chips) 
fightingnuns: posts small blind $2
davidb1962: posts big blind $4
*** HOLE CARDS ***
Dealt to fightingnuns [9c 6d]
fightingnuns: raises $4 to $8
davidb1962: raises $16 to $24
fightingnuns: folds 
Uncalled bet ($16) returned to davidb1962
davidb1962 collected $16 from pot
*** SUMMARY ***
Total pot $16 | Rake $0 
Seat 1: fightingnuns (button) (small blind) folded before Flop
Seat 2: davidb1962 (big blind) collected ($16)



PokerStars Game #59726180087:  Hold'em No Limit ($2/$4 USD) - 2011/03/24 13:53:50 ET
Table 'Thekla IX' 2-max Seat #2 is the button
Seat 1: fightingnuns ($281.50 in chips) 
Seat 2: davidb1962 ($102.70 in chips) 
davidb1962: posts small blind $2
fightingnuns: posts big blind $4
*** HOLE CARDS ***
Dealt to fightingnuns [6c 7h]
davidb1962: raises $4 to $8
fightingnuns: folds 
Uncalled bet ($4) returned to davidb1962
davidb1962 collected $8 from pot
*** SUMMARY ***
Total pot $8 | Rake $0 
Seat 1: fightingnuns (big blind) folded before Flop
Seat 2: davidb1962 (button) (small blind) collected ($8)



PokerStars Game #59726187633:  Hold'em No Limit ($2/$4 USD) - 2011/03/24 13:53:58 ET
Table 'Thekla IX' 2-max Seat #1 is the button
Seat 1: fightingnuns ($277.50 in chips) 
Seat 2: davidb1962 ($106.70 in chips) 
fightingnuns: posts small blind $2
davidb1962: posts big blind $4
*** HOLE CARDS ***
Dealt to fightingnuns [Ac 6h]
fightingnuns: raises $4 to $8
davidb1962: calls $4
*** FLOP *** [Ts 3s Kh]
davidb1962: checks 
fightingnuns: checks 
*** TURN *** [Ts 3s Kh] [3d]
davidb1962: checks 
fightingnuns: checks 
*** RIVER *** [Ts 3s Kh 3d] [Th]
davidb1962: checks 
fightingnuns: checks 
*** SHOW DOWN ***
davidb1962: shows [8c 7c] (two pair, Tens and Threes)
fightingnuns: shows [Ac 6h] (two pair, Tens and Threes - Ace kicker)
fightingnuns collected $15.50 from pot
*** SUMMARY ***
Total pot $16 | Rake $0.50 
Board [Ts 3s Kh 3d Th]
Seat 1: fightingnuns (button) (small blind) showed [Ac 6h] and won ($15.50) with two pair, Tens and Threes
Seat 2: davidb1962 (big blind) showed [8c 7c] and lost with two pair, Tens and Threes



PokerStars Game #59726214724:  Hold'em No Limit ($2/$4 USD) - 2011/03/24 13:54:28 ET
Table 'Thekla IX' 2-max Seat #2 is the button
Seat 1: fightingnuns ($285 in chips) 
Seat 2: davidb1962 ($98.70 in chips) 
davidb1962: posts small blind $2
fightingnuns: posts big blind $4
*** HOLE CARDS ***
Dealt to fightingnuns [3d 2c]
davidb1962: folds 
Uncalled bet ($2) returned to fightingnuns
fightingnuns collected $4 from pot
fightingnuns: doesn't show hand 
*** SUMMARY ***
Total pot $4 | Rake $0 
Seat 1: fightingnuns (big blind) collected ($4)
Seat 2: davidb1962 (button) (small blind) folded before Flop



PokerStars Game #59726219972:  Hold'em No Limit ($2/$4 USD) - 2011/03/24 13:54:34 ET
Table 'Thekla IX' 2-max Seat #1 is the button
Seat 1: fightingnuns ($287 in chips) 
Seat 2: davidb1962 ($96.70 in chips) 
fightingnuns: posts small blind $2
davidb1962: posts big blind $4
*** HOLE CARDS ***
Dealt to fightingnuns [Qd 3s]
fightingnuns: folds 
Uncalled bet ($2) returned to davidb1962
davidb1962 collected $4 from pot
*** SUMMARY ***
Total pot $4 | Rake $0 
Seat 1: fightingnuns (button) (small blind) folded before Flop
Seat 2: davidb1962 (big blind) collected ($4)



PokerStars Game #59726228284:  Hold'em No Limit ($2/$4 USD) - 2011/03/24 13:54:44 ET
Table 'Thekla IX' 2-max Seat #2 is the button
Seat 1: fightingnuns ($285 in chips) 
Seat 2: davidb1962 ($98.70 in chips) 
davidb1962: posts small blind $2
fightingnuns: posts big blind $4
*** HOLE CARDS ***
Dealt to fightingnuns [4d Kh]
davidb1962: folds 
Uncalled bet ($2) returned to fightingnuns
fightingnuns collected $4 from pot
fightingnuns: doesn't show hand 
*** SUMMARY ***
Total pot $4 | Rake $0 
Seat 1: fightingnuns (big blind) collected ($4)
Seat 2: davidb1962 (button) (small blind) folded before Flop



PokerStars Game #59726233446:  Hold'em No Limit ($2/$4 USD) - 2011/03/24 13:54:50 ET
Table 'Thekla IX' 2-max Seat #1 is the button
Seat 1: fightingnuns ($287 in chips) 
Seat 2: davidb1962 ($96.70 in chips) 
fightingnuns: posts small blind $2
davidb1962: posts big blind $4
*** HOLE CARDS ***
Dealt to fightingnuns [5h Kc]
fightingnuns: raises $4 to $8
davidb1962: calls $4
*** FLOP *** [9d 2c Js]
davidb1962: checks 
fightingnuns: checks 
*** TURN *** [9d 2c Js] [Jh]
davidb1962: checks 
fightingnuns: checks 
*** RIVER *** [9d 2c Js Jh] [3s]
davidb1962: checks 
fightingnuns: checks 
*** SHOW DOWN ***
davidb1962: shows [6d 8h] (a pair of Jacks)
fightingnuns: shows [5h Kc] (a pair of Jacks - King kicker)
fightingnuns collected $15.50 from pot
*** SUMMARY ***
Total pot $16 | Rake $0.50 
Board [9d 2c Js Jh 3s]
Seat 1: fightingnuns (button) (small blind) showed [5h Kc] and won ($15.50) with a pair of Jacks
Seat 2: davidb1962 (big blind) showed [6d 8h] and lost with a pair of Jacks



PokerStars Game #59726253033:  Hold'em No Limit ($2/$4 USD) - 2011/03/24 13:55:14 ET
Table 'Thekla IX' 2-max Seat #2 is the button
Seat 1: fightingnuns ($294.50 in chips) 
Seat 2: davidb1962 ($88.70 in chips) 
davidb1962: posts small blind $2
fightingnuns: posts big blind $4
*** HOLE CARDS ***
Dealt to fightingnuns [4c Qc]
davidb1962: folds 
Uncalled bet ($2) returned to fightingnuns
fightingnuns collected $4 from pot
fightingnuns: doesn't show hand 
*** SUMMARY ***
Total pot $4 | Rake $0 
Seat 1: fightingnuns (big blind) collected ($4)
Seat 2: davidb1962 (button) (small blind) folded before Flop



PokerStars Game #59726256830:  Hold'em No Limit ($2/$4 USD) - 2011/03/24 13:55:20 ET
Table 'Thekla IX' 2-max Seat #1 is the button
Seat 1: fightingnuns ($296.50 in chips) 
Seat 2: davidb1962 ($86.70 in chips) 
fightingnuns: posts small blind $2
davidb1962: posts big blind $4
*** HOLE CARDS ***
Dealt to fightingnuns [9h 2c]
fightingnuns: folds 
Uncalled bet ($2) returned to davidb1962
davidb1962 collected $4 from pot
*** SUMMARY ***
Total pot $4 | Rake $0 
Seat 1: fightingnuns (button) (small blind) folded before Flop
Seat 2: davidb1962 (big blind) collected ($4)



PokerStars Game #59726261463:  Hold'em No Limit ($2/$4 USD) - 2011/03/24 13:55:27 ET
Table 'Thekla IX' 2-max Seat #2 is the button
Seat 1: fightingnuns ($294.50 in chips) 
Seat 2: davidb1962 ($88.70 in chips) 
davidb1962: posts small blind $2
fightingnuns: posts big blind $4
*** HOLE CARDS ***
Dealt to fightingnuns [8d 8s]
davidb1962: raises $8 to $12
fightingnuns: raises $282.50 to $294.50 and is all-in
davidb1962: calls $76.70 and is all-in
Uncalled bet ($205.80) returned to fightingnuns
*** FLOP *** [5c 6h 3s]
*** TURN *** [5c 6h 3s] [4h]
*** RIVER *** [5c 6h 3s 4h] [Jd]
*** SHOW DOWN ***
fightingnuns: shows [8d 8s] (a pair of Eights)
davidb1962: shows [9s 9d] (a pair of Nines)
davidb1962 collected $176.90 from pot
*** SUMMARY ***
Total pot $177.40 | Rake $0.50 
Board [5c 6h 3s 4h Jd]
Seat 1: fightingnuns (big blind) showed [8d 8s] and lost with a pair of Eights
Seat 2: davidb1962 (button) (small blind) showed [9s 9d] and won ($176.90) with a pair of Nines



PokerStars Game #59726278310:  Hold'em No Limit ($2/$4 USD) - 2011/03/24 13:55:51 ET
Table 'Thekla IX' 2-max Seat #1 is the button
Seat 1: fightingnuns ($205.80 in chips) 
Seat 2: davidb1962 ($176.90 in chips) 
fightingnuns: posts small blind $2
davidb1962: posts big blind $4
*** HOLE CARDS ***
Dealt to fightingnuns [2s Qh]
fightingnuns: raises $4 to $8
davidb1962: calls $4
*** FLOP *** [8d 7c Kd]
davidb1962: checks 
fightingnuns: bets $12
davidb1962: calls $12
*** TURN *** [8d 7c Kd] [6c]
davidb1962: checks 
fightingnuns: checks 
*** RIVER *** [8d 7c Kd 6c] [9s]
davidb1962: checks 
fightingnuns: bets $32
davidb1962: folds 
Uncalled bet ($32) returned to fightingnuns
fightingnuns collected $39.50 from pot
fightingnuns: doesn't show hand 
*** SUMMARY ***
Total pot $40 | Rake $0.50 
Board [8d 7c Kd 6c 9s]
Seat 1: fightingnuns (button) (small blind) collected ($39.50)
Seat 2: davidb1962 (big blind) folded on the River



PokerStars Game #59726301852:  Hold'em No Limit ($2/$4 USD) - 2011/03/24 13:56:26 ET
Table 'Thekla IX' 2-max Seat #2 is the button
Seat 1: fightingnuns ($225.30 in chips) 
Seat 2: davidb1962 ($156.90 in chips) 
davidb1962: posts small blind $2
fightingnuns: posts big blind $4
*** HOLE CARDS ***
Dealt to fightingnuns [Ah 5h]
davidb1962: folds 
Uncalled bet ($2) returned to fightingnuns
fightingnuns collected $4 from pot
fightingnuns: doesn't show hand 
*** SUMMARY ***
Total pot $4 | Rake $0 
Seat 1: fightingnuns (big blind) collected ($4)
Seat 2: davidb1962 (button) (small blind) folded before Flop



PokerStars Game #59726305689:  Hold'em No Limit ($2/$4 USD) - 2011/03/24 13:56:32 ET
Table 'Thekla IX' 2-max Seat #1 is the button
Seat 1: fightingnuns ($227.30 in chips) 
Seat 2: davidb1962 ($154.90 in chips) 
fightingnuns: posts small blind $2
davidb1962: posts big blind $4
*** HOLE CARDS ***
Dealt to fightingnuns [Kd Js]
fightingnuns: raises $4 to $8
davidb1962: folds 
Uncalled bet ($4) returned to fightingnuns
fightingnuns collected $8 from pot
fightingnuns: doesn't show hand 
*** SUMMARY ***
Total pot $8 | Rake $0 
Seat 1: fightingnuns (button) (small blind) collected ($8)
Seat 2: davidb1962 (big blind) folded before Flop



PokerStars Game #59726310351:  Hold'em No Limit ($2/$4 USD) - 2011/03/24 13:56:39 ET
Table 'Thekla IX' 2-max Seat #2 is the button
Seat 1: fightingnuns ($231.30 in chips) 
Seat 2: davidb1962 ($150.90 in chips) 
davidb1962: posts small blind $2
fightingnuns: posts big blind $4
*** HOLE CARDS ***
Dealt to fightingnuns [Ah Jd]
davidb1962: raises $8 to $12
fightingnuns: raises $24 to $36
davidb1962: folds 
Uncalled bet ($24) returned to fightingnuns
fightingnuns collected $24 from pot
fightingnuns: doesn't show hand 
*** SUMMARY ***
Total pot $24 | Rake $0 
Seat 1: fightingnuns (big blind) collected ($24)
Seat 2: davidb1962 (button) (small blind) folded before Flop



PokerStars Game #59726320229:  Hold'em No Limit ($2/$4 USD) - 2011/03/24 13:56:53 ET
Table 'Thekla IX' 2-max Seat #1 is the button
Seat 1: fightingnuns ($243.30 in chips) 
Seat 2: davidb1962 ($138.90 in chips) 
fightingnuns: posts small blind $2
davidb1962: posts big blind $4
*** HOLE CARDS ***
Dealt to fightingnuns [4h 7s]
fightingnuns: folds 
Uncalled bet ($2) returned to davidb1962
davidb1962 collected $4 from pot
*** SUMMARY ***
Total pot $4 | Rake $0 
Seat 1: fightingnuns (button) (small blind) folded before Flop
Seat 2: davidb1962 (big blind) collected ($4)



PokerStars Game #59726324736:  Hold'em No Limit ($2/$4 USD) - 2011/03/24 13:57:00 ET
Table 'Thekla IX' 2-max Seat #2 is the button
Seat 1: fightingnuns ($241.30 in chips) 
Seat 2: davidb1962 ($140.90 in chips) 
davidb1962: posts small blind $2
fightingnuns: posts big blind $4
*** HOLE CARDS ***
Dealt to fightingnuns [9d 3h]
davidb1962: raises $4 to $8
fightingnuns: folds 
Uncalled bet ($4) returned to davidb1962
davidb1962 collected $8 from pot
*** SUMMARY ***
Total pot $8 | Rake $0 
Seat 1: fightingnuns (big blind) folded before Flop
Seat 2: davidb1962 (button) (small blind) collected ($8)



PokerStars Game #59726331044:  Hold'em No Limit ($2/$4 USD) - 2011/03/24 13:57:09 ET
Table 'Thekla IX' 2-max Seat #1 is the button
Seat 1: fightingnuns ($237.30 in chips) 
Seat 2: davidb1962 ($144.90 in chips) 
fightingnuns: posts small blind $2
davidb1962: posts big blind $4
*** HOLE CARDS ***
Dealt to fightingnuns [5s 3s]
fightingnuns: raises $4 to $8
davidb1962: folds 
Uncalled bet ($4) returned to fightingnuns
fightingnuns collected $8 from pot
fightingnuns: doesn't show hand 
*** SUMMARY ***
Total pot $8 | Rake $0 
Seat 1: fightingnuns (button) (small blind) collected ($8)
Seat 2: davidb1962 (big blind) folded before Flop



PokerStars Game #59726337003:  Hold'em No Limit ($2/$4 USD) - 2011/03/24 13:57:18 ET
Table 'Thekla IX' 2-max Seat #2 is the button
Seat 1: fightingnuns ($241.30 in chips) 
Seat 2: davidb1962 ($140.90 in chips) 
davidb1962: posts small blind $2
fightingnuns: posts big blind $4
*** HOLE CARDS ***
Dealt to fightingnuns [Ad Jd]
davidb1962: raises $4 to $8
fightingnuns: raises $16 to $24
davidb1962: calls $16
*** FLOP *** [Kh 8h As]
fightingnuns: bets $32
davidb1962: raises $84.90 to $116.90 and is all-in
fightingnuns: calls $84.90
*** TURN *** [Kh 8h As] [7h]
*** RIVER *** [Kh 8h As 7h] [7d]
*** SHOW DOWN ***
fightingnuns: shows [Ad Jd] (two pair, Aces and Sevens)
davidb1962: shows [8c Ac] (two pair, Aces and Eights)
davidb1962 collected $281.30 from pot
*** SUMMARY ***
Total pot $281.80 | Rake $0.50 
Board [Kh 8h As 7h 7d]
Seat 1: fightingnuns (big blind) showed [Ad Jd] and lost with two pair, Aces and Sevens
Seat 2: davidb1962 (button) (small blind) showed [8c Ac] and won ($281.30) with two pair, Aces and Eights



PokerStars Game #59726356373:  Hold'em No Limit ($2/$4 USD) - 2011/03/24 13:57:46 ET
Table 'Thekla IX' 2-max Seat #1 is the button
Seat 1: fightingnuns ($200 in chips) 
Seat 2: davidb1962 ($281.30 in chips) 
fightingnuns: posts small blind $2
davidb1962: posts big blind $4
*** HOLE CARDS ***
Dealt to fightingnuns [5c 3h]
fightingnuns: folds 
Uncalled bet ($2) returned to davidb1962
davidb1962 collected $4 from pot
*** SUMMARY ***
Total pot $4 | Rake $0 
Seat 1: fightingnuns (button) (small blind) folded before Flop
Seat 2: davidb1962 (big blind) collected ($4)



PokerStars Game #59726361225:  Hold'em No Limit ($2/$4 USD) - 2011/03/24 13:57:53 ET
Table 'Thekla IX' 2-max Seat #2 is the button
Seat 1: fightingnuns ($200 in chips) 
Seat 2: davidb1962 ($283.30 in chips) 
davidb1962: posts small blind $2
fightingnuns: posts big blind $4
*** HOLE CARDS ***
Dealt to fightingnuns [Ah 4h]
davidb1962: folds 
Uncalled bet ($2) returned to fightingnuns
fightingnuns collected $4 from pot
fightingnuns: doesn't show hand 
*** SUMMARY ***
Total pot $4 | Rake $0 
Seat 1: fightingnuns (big blind) collected ($4)
Seat 2: davidb1962 (button) (small blind) folded before Flop



PokerStars Game #59726365152:  Hold'em No Limit ($2/$4 USD) - 2011/03/24 13:57:59 ET
Table 'Thekla IX' 2-max Seat #1 is the button
Seat 1: fightingnuns ($202 in chips) 
Seat 2: davidb1962 ($281.30 in chips) 
fightingnuns: posts small blind $2
davidb1962: posts big blind $4
*** HOLE CARDS ***
Dealt to fightingnuns [4s Ts]
fightingnuns: raises $4 to $8
davidb1962: calls $4
*** FLOP *** [8s Jd Js]
davidb1962: checks 
fightingnuns: bets $12
davidb1962: folds 
Uncalled bet ($12) returned to fightingnuns
davidb1962 leaves the table
fightingnuns collected $15.50 from pot
fightingnuns: doesn't show hand 
*** SUMMARY ***
Total pot $16 | Rake $0.50 
Board [8s Jd Js]
Seat 1: fightingnuns (button) (small blind) collected ($15.50)
Seat 2: davidb1962 (big blind) folded on the Flop



PokerStars Game #59731659172:  Hold'em No Limit ($2/$4 USD) - 2011/03/24 15:29:49 ET
Table 'Thekla IX' 2-max Seat #2 is the button
Seat 1: fightingnuns ($209.50 in chips) 
Seat 2: Najammq ($160 in chips) 
Najammq: posts small blind $2
fightingnuns: posts big blind $4
*** HOLE CARDS ***
Dealt to fightingnuns [7h Kd]
Najammq: folds 
Uncalled bet ($2) returned to fightingnuns
fightingnuns collected $4 from pot
fightingnuns: doesn't show hand 
*** SUMMARY ***
Total pot $4 | Rake $0 
Seat 1: fightingnuns (big blind) collected ($4)
Seat 2: Najammq (button) (small blind) folded before Flop



PokerStars Game #59731666458:  Hold'em No Limit ($2/$4 USD) - 2011/03/24 15:29:56 ET
Table 'Thekla IX' 2-max Seat #1 is the button
Seat 1: fightingnuns ($211.50 in chips) 
Seat 2: Najammq ($158 in chips) 
fightingnuns: posts small blind $2
Najammq: posts big blind $4
*** HOLE CARDS ***
Dealt to fightingnuns [9h 3s]
fightingnuns: raises $4 to $8
Najammq: folds 
Uncalled bet ($4) returned to fightingnuns
fightingnuns collected $8 from pot
fightingnuns: doesn't show hand 
*** SUMMARY ***
Total pot $8 | Rake $0 
Seat 1: fightingnuns (button) (small blind) collected ($8)
Seat 2: Najammq (big blind) folded before Flop



PokerStars Game #59731681393:  Hold'em No Limit ($2/$4 USD) - 2011/03/24 15:30:10 ET
Table 'Thekla IX' 2-max Seat #2 is the button
Seat 1: fightingnuns ($215.50 in chips) 
Seat 2: Najammq ($154 in chips) 
Najammq: posts small blind $2
fightingnuns: posts big blind $4
*** HOLE CARDS ***
Dealt to fightingnuns [Th 8d]
Najammq: folds 
Uncalled bet ($2) returned to fightingnuns
fightingnuns collected $4 from pot
fightingnuns: doesn't show hand 
*** SUMMARY ***
Total pot $4 | Rake $0 
Seat 1: fightingnuns (big blind) collected ($4)
Seat 2: Najammq (button) (small blind) folded before Flop



PokerStars Game #59731689482:  Hold'em No Limit ($2/$4 USD) - 2011/03/24 15:30:18 ET
Table 'Thekla IX' 2-max Seat #1 is the button
Seat 1: fightingnuns ($217.50 in chips) 
Seat 2: Najammq ($152 in chips) 
fightingnuns: posts small blind $2
Najammq: posts big blind $4
*** HOLE CARDS ***
Dealt to fightingnuns [Jd 2c]
fightingnuns: raises $4 to $8
Najammq: calls $4
*** FLOP *** [Jh 3s Ah]
Najammq: checks 
fightingnuns: checks 
*** TURN *** [Jh 3s Ah] [Kc]
Najammq: bets $12
fightingnuns: folds 
Uncalled bet ($12) returned to Najammq
Najammq collected $15.50 from pot
*** SUMMARY ***
Total pot $16 | Rake $0.50 
Board [Jh 3s Ah Kc]
Seat 1: fightingnuns (button) (small blind) folded on the Turn
Seat 2: Najammq (big blind) collected ($15.50)



PokerStars Game #59731721125:  Hold'em No Limit ($2/$4 USD) - 2011/03/24 15:30:49 ET
Table 'Thekla IX' 2-max Seat #2 is the button
Seat 1: fightingnuns ($209.50 in chips) 
Seat 2: Najammq ($159.50 in chips) 
Najammq: posts small blind $2
fightingnuns: posts big blind $4
*** HOLE CARDS ***
Dealt to fightingnuns [7h 4d]
Najammq: folds 
Uncalled bet ($2) returned to fightingnuns
fightingnuns collected $4 from pot
*** SUMMARY ***
Total pot $4 | Rake $0 
Seat 1: fightingnuns (big blind) collected ($4)
Seat 2: Najammq (button) (small blind) folded before Flop



PokerStars Game #59731727818:  Hold'em No Limit ($2/$4 USD) - 2011/03/24 15:30:56 ET
Table 'Thekla IX' 2-max Seat #1 is the button
Seat 1: fightingnuns ($211.50 in chips) 
Seat 2: Najammq ($157.50 in chips) 
fightingnuns: posts small blind $2
Najammq: posts big blind $4
*** HOLE CARDS ***
Dealt to fightingnuns [8c 4h]
fightingnuns: raises $4 to $8
Najammq: folds 
Uncalled bet ($4) returned to fightingnuns
fightingnuns collected $8 from pot
fightingnuns: doesn't show hand 
*** SUMMARY ***
Total pot $8 | Rake $0 
Seat 1: fightingnuns (button) (small blind) collected ($8)
Seat 2: Najammq (big blind) folded before Flop



PokerStars Game #59731736400:  Hold'em No Limit ($2/$4 USD) - 2011/03/24 15:31:04 ET
Table 'Thekla IX' 2-max Seat #2 is the button
Seat 1: fightingnuns ($215.50 in chips) 
Seat 2: Najammq ($153.50 in chips) 
Najammq: posts small blind $2
fightingnuns: posts big blind $4
*** HOLE CARDS ***
Dealt to fightingnuns [5c Js]
Najammq: raises $4 to $8
fightingnuns: folds 
Uncalled bet ($4) returned to Najammq
Najammq collected $8 from pot
*** SUMMARY ***
Total pot $8 | Rake $0 
Seat 1: fightingnuns (big blind) folded before Flop
Seat 2: Najammq (button) (small blind) collected ($8)



PokerStars Game #59731748593:  Hold'em No Limit ($2/$4 USD) - 2011/03/24 15:31:16 ET
Table 'Thekla IX' 2-max Seat #1 is the button
Seat 1: fightingnuns ($211.50 in chips) 
Seat 2: Najammq ($157.50 in chips) 
fightingnuns: posts small blind $2
Najammq: posts big blind $4
*** HOLE CARDS ***
Dealt to fightingnuns [5c Kh]
fightingnuns: raises $4 to $8
Najammq: raises $20 to $28
fightingnuns: folds 
Uncalled bet ($20) returned to Najammq
Najammq collected $16 from pot
*** SUMMARY ***
Total pot $16 | Rake $0 
Seat 1: fightingnuns (button) (small blind) folded before Flop
Seat 2: Najammq (big blind) collected ($16)



PokerStars Game #59731769183:  Hold'em No Limit ($2/$4 USD) - 2011/03/24 15:31:35 ET
Table 'Thekla IX' 2-max Seat #2 is the button
Seat 1: fightingnuns ($203.50 in chips) 
Seat 2: Najammq ($165.50 in chips) 
Najammq: posts small blind $2
fightingnuns: posts big blind $4
*** HOLE CARDS ***
Dealt to fightingnuns [3s 9s]
Najammq: raises $4 to $8
fightingnuns: folds 
Uncalled bet ($4) returned to Najammq
Najammq collected $8 from pot
*** SUMMARY ***
Total pot $8 | Rake $0 
Seat 1: fightingnuns (big blind) folded before Flop
Seat 2: Najammq (button) (small blind) collected ($8)



PokerStars Game #59731777226:  Hold'em No Limit ($2/$4 USD) - 2011/03/24 15:31:43 ET
Table 'Thekla IX' 2-max Seat #1 is the button
Seat 1: fightingnuns ($200 in chips) 
Seat 2: Najammq ($169.50 in chips) 
fightingnuns: posts small blind $2
Najammq: posts big blind $4
*** HOLE CARDS ***
Dealt to fightingnuns [8c 9d]
fightingnuns: raises $4 to $8
Najammq: calls $4
*** FLOP *** [Kh Jc Qh]
Najammq: checks 
fightingnuns: bets $12
Najammq: folds 
Uncalled bet ($12) returned to fightingnuns
fightingnuns collected $15.50 from pot
fightingnuns: doesn't show hand 
*** SUMMARY ***
Total pot $16 | Rake $0.50 
Board [Kh Jc Qh]
Seat 1: fightingnuns (button) (small blind) collected ($15.50)
Seat 2: Najammq (big blind) folded on the Flop



PokerStars Game #59731821945:  Hold'em No Limit ($2/$4 USD) - 2011/03/24 15:32:26 ET
Table 'Thekla IX' 2-max Seat #2 is the button
Seat 1: fightingnuns ($207.50 in chips) 
Seat 2: Najammq ($161.50 in chips) 
Najammq: posts small blind $2
fightingnuns: posts big blind $4
*** HOLE CARDS ***
Dealt to fightingnuns [9s 9c]
Najammq: raises $4 to $8
fightingnuns: raises $20 to $28
Najammq: folds 
Uncalled bet ($20) returned to fightingnuns
fightingnuns collected $16 from pot
fightingnuns: doesn't show hand 
*** SUMMARY ***
Total pot $16 | Rake $0 
Seat 1: fightingnuns (big blind) collected ($16)
Seat 2: Najammq (button) (small blind) folded before Flop



PokerStars Game #59731839334:  Hold'em No Limit ($2/$4 USD) - 2011/03/24 15:32:43 ET
Table 'Thekla IX' 2-max Seat #1 is the button
Seat 1: fightingnuns ($215.50 in chips) 
Seat 2: Najammq ($153.50 in chips) 
fightingnuns: posts small blind $2
Najammq: posts big blind $4
*** HOLE CARDS ***
Dealt to fightingnuns [Ah 2h]
fightingnuns: raises $4 to $8
Najammq: raises $20 to $28
fightingnuns: folds 
Uncalled bet ($20) returned to Najammq
Najammq collected $16 from pot
*** SUMMARY ***
Total pot $16 | Rake $0 
Seat 1: fightingnuns (button) (small blind) folded before Flop
Seat 2: Najammq (big blind) collected ($16)



PokerStars Game #59731855653:  Hold'em No Limit ($2/$4 USD) - 2011/03/24 15:32:59 ET
Table 'Thekla IX' 2-max Seat #2 is the button
Seat 1: fightingnuns ($207.50 in chips) 
Seat 2: Najammq ($161.50 in chips) 
Najammq: posts small blind $2
fightingnuns: posts big blind $4
*** HOLE CARDS ***
Dealt to fightingnuns [3s 8h]
Najammq: raises $4 to $8
fightingnuns: folds 
Uncalled bet ($4) returned to Najammq
Najammq collected $8 from pot
*** SUMMARY ***
Total pot $8 | Rake $0 
Seat 1: fightingnuns (big blind) folded before Flop
Seat 2: Najammq (button) (small blind) collected ($8)



PokerStars Game #59731869001:  Hold'em No Limit ($2/$4 USD) - 2011/03/24 15:33:12 ET
Table 'Thekla IX' 2-max Seat #1 is the button
Seat 1: fightingnuns ($203.50 in chips) 
Seat 2: Najammq ($165.50 in chips) 
fightingnuns: posts small blind $2
Najammq: posts big blind $4
*** HOLE CARDS ***
Dealt to fightingnuns [As 6h]
fightingnuns: raises $4 to $8
Najammq: folds 
Uncalled bet ($4) returned to fightingnuns
fightingnuns collected $8 from pot
*** SUMMARY ***
Total pot $8 | Rake $0 
Seat 1: fightingnuns (button) (small blind) collected ($8)
Seat 2: Najammq (big blind) folded before Flop



PokerStars Game #59731878971:  Hold'em No Limit ($2/$4 USD) - 2011/03/24 15:33:22 ET
Table 'Thekla IX' 2-max Seat #2 is the button
Seat 1: fightingnuns ($207.50 in chips) 
Seat 2: Najammq ($161.50 in chips) 
Najammq: posts small blind $2
fightingnuns: posts big blind $4
*** HOLE CARDS ***
Dealt to fightingnuns [7c 2h]
Najammq: raises $4 to $8
fightingnuns: folds 
Uncalled bet ($4) returned to Najammq
Najammq collected $8 from pot
*** SUMMARY ***
Total pot $8 | Rake $0 
Seat 1: fightingnuns (big blind) folded before Flop
Seat 2: Najammq (button) (small blind) collected ($8)



PokerStars Game #59731893181:  Hold'em No Limit ($2/$4 USD) - 2011/03/24 15:33:36 ET
Table 'Thekla IX' 2-max Seat #1 is the button
Seat 1: fightingnuns ($203.50 in chips) 
Seat 2: Najammq ($165.50 in chips) 
fightingnuns: posts small blind $2
Najammq: posts big blind $4
*** HOLE CARDS ***
Dealt to fightingnuns [5h 2d]
fightingnuns: folds 
Uncalled bet ($2) returned to Najammq
Najammq collected $4 from pot
*** SUMMARY ***
Total pot $4 | Rake $0 
Seat 1: fightingnuns (button) (small blind) folded before Flop
Seat 2: Najammq (big blind) collected ($4)



PokerStars Game #59731900739:  Hold'em No Limit ($2/$4 USD) - 2011/03/24 15:33:43 ET
Table 'Thekla IX' 2-max Seat #2 is the button
Seat 1: fightingnuns ($201.50 in chips) 
Seat 2: Najammq ($167.50 in chips) 
Najammq: posts small blind $2
fightingnuns: posts big blind $4
*** HOLE CARDS ***
Dealt to fightingnuns [6c 5d]
Najammq: folds 
Uncalled bet ($2) returned to fightingnuns
fightingnuns collected $4 from pot
fightingnuns: doesn't show hand 
*** SUMMARY ***
Total pot $4 | Rake $0 
Seat 1: fightingnuns (big blind) collected ($4)
Seat 2: Najammq (button) (small blind) folded before Flop



PokerStars Game #59731908529:  Hold'em No Limit ($2/$4 USD) - 2011/03/24 15:33:51 ET
Table 'Thekla IX' 2-max Seat #1 is the button
Seat 1: fightingnuns ($203.50 in chips) 
Seat 2: Najammq ($165.50 in chips) 
fightingnuns: posts small blind $2
Najammq: posts big blind $4
*** HOLE CARDS ***
Dealt to fightingnuns [Ah 5d]
fightingnuns: raises $4 to $8
Najammq: calls $4
*** FLOP *** [7h As 9c]
Najammq: checks 
fightingnuns: bets $12
Najammq: calls $12
*** TURN *** [7h As 9c] [Js]
Najammq: checks 
fightingnuns: checks 
*** RIVER *** [7h As 9c Js] [6h]
Najammq: bets $24
fightingnuns: calls $24
*** SHOW DOWN ***
Najammq: shows [6d 9d] (two pair, Nines and Sixes)
fightingnuns: mucks hand 
Najammq collected $87.50 from pot
*** SUMMARY ***
Total pot $88 | Rake $0.50 
Board [7h As 9c Js 6h]
Seat 1: fightingnuns (button) (small blind) mucked [Ah 5d]
Seat 2: Najammq (big blind) showed [6d 9d] and won ($87.50) with two pair, Nines and Sixes



PokerStars Game #59731953301:  Hold'em No Limit ($2/$4 USD) - 2011/03/24 15:34:35 ET
Table 'Thekla IX' 2-max Seat #2 is the button
Seat 1: fightingnuns ($200 in chips) 
Seat 2: Najammq ($209 in chips) 
Najammq: posts small blind $2
fightingnuns: posts big blind $4
*** HOLE CARDS ***
Dealt to fightingnuns [Qh Qc]
Najammq: raises $4 to $8
fightingnuns: raises $20 to $28
Najammq: folds 
Uncalled bet ($20) returned to fightingnuns
fightingnuns collected $16 from pot
fightingnuns: doesn't show hand 
*** SUMMARY ***
Total pot $16 | Rake $0 
Seat 1: fightingnuns (big blind) collected ($16)
Seat 2: Najammq (button) (small blind) folded before Flop



PokerStars Game #59731976836:  Hold'em No Limit ($2/$4 USD) - 2011/03/24 15:34:57 ET
Table 'Thekla IX' 2-max Seat #1 is the button
Seat 1: fightingnuns ($208 in chips) 
Seat 2: Najammq ($201 in chips) 
fightingnuns: posts small blind $2
Najammq: posts big blind $4
*** HOLE CARDS ***
Dealt to fightingnuns [2d Kc]
fightingnuns: raises $4 to $8
Najammq: folds 
Uncalled bet ($4) returned to fightingnuns
fightingnuns collected $8 from pot
*** SUMMARY ***
Total pot $8 | Rake $0 
Seat 1: fightingnuns (button) (small blind) collected ($8)
Seat 2: Najammq (big blind) folded before Flop



PokerStars Game #59731988739:  Hold'em No Limit ($2/$4 USD) - 2011/03/24 15:35:07 ET
Table 'Thekla IX' 2-max Seat #2 is the button
Seat 1: fightingnuns ($212 in chips) 
Seat 2: Najammq ($197 in chips) 
Najammq: posts small blind $2
fightingnuns: posts big blind $4
*** HOLE CARDS ***
Dealt to fightingnuns [Tc Jc]
Najammq: raises $4 to $8
fightingnuns: calls $4
*** FLOP *** [5h 7h 5s]
fightingnuns: checks 
Najammq: checks 
*** TURN *** [5h 7h 5s] [7d]
fightingnuns: checks 
Najammq: bets $12
fightingnuns: folds 
Uncalled bet ($12) returned to Najammq
Najammq collected $15.50 from pot
*** SUMMARY ***
Total pot $16 | Rake $0.50 
Board [5h 7h 5s 7d]
Seat 1: fightingnuns (big blind) folded on the Turn
Seat 2: Najammq (button) (small blind) collected ($15.50)



PokerStars Game #59732013100:  Hold'em No Limit ($2/$4 USD) - 2011/03/24 15:35:30 ET
Table 'Thekla IX' 2-max Seat #1 is the button
Seat 1: fightingnuns ($204 in chips) 
Seat 2: Najammq ($204.50 in chips) 
fightingnuns: posts small blind $2
Najammq: posts big blind $4
*** HOLE CARDS ***
Dealt to fightingnuns [5h 9d]
fightingnuns: raises $4 to $8
Najammq: folds 
Uncalled bet ($4) returned to fightingnuns
fightingnuns collected $8 from pot
fightingnuns: doesn't show hand 
*** SUMMARY ***
Total pot $8 | Rake $0 
Seat 1: fightingnuns (button) (small blind) collected ($8)
Seat 2: Najammq (big blind) folded before Flop



PokerStars Game #59732025992:  Hold'em No Limit ($2/$4 USD) - 2011/03/24 15:35:43 ET
Table 'Thekla IX' 2-max Seat #2 is the button
Seat 1: fightingnuns ($208 in chips) 
Seat 2: Najammq ($200.50 in chips) 
Najammq: posts small blind $2
fightingnuns: posts big blind $4
*** HOLE CARDS ***
Dealt to fightingnuns [9s 4c]
Najammq: folds 
Uncalled bet ($2) returned to fightingnuns
fightingnuns collected $4 from pot
fightingnuns: doesn't show hand 
*** SUMMARY ***
Total pot $4 | Rake $0 
Seat 1: fightingnuns (big blind) collected ($4)
Seat 2: Najammq (button) (small blind) folded before Flop



PokerStars Game #59732035042:  Hold'em No Limit ($2/$4 USD) - 2011/03/24 15:35:51 ET
Table 'Thekla IX' 2-max Seat #1 is the button
Seat 1: fightingnuns ($210 in chips) 
Seat 2: Najammq ($198.50 in chips) 
fightingnuns: posts small blind $2
Najammq: posts big blind $4
*** HOLE CARDS ***
Dealt to fightingnuns [3h Kd]
fightingnuns: raises $4 to $8
Najammq: calls $4
*** FLOP *** [5c 3d 2c]
Najammq: checks 
fightingnuns: bets $12
Najammq: folds 
Uncalled bet ($12) returned to fightingnuns
fightingnuns collected $15.50 from pot
fightingnuns: doesn't show hand 
*** SUMMARY ***
Total pot $16 | Rake $0.50 
Board [5c 3d 2c]
Seat 1: fightingnuns (button) (small blind) collected ($15.50)
Seat 2: Najammq (big blind) folded on the Flop



PokerStars Game #59732062554:  Hold'em No Limit ($2/$4 USD) - 2011/03/24 15:36:17 ET
Table 'Thekla IX' 2-max Seat #2 is the button
Seat 1: fightingnuns ($217.50 in chips) 
Seat 2: Najammq ($190.50 in chips) 
Najammq: posts small blind $2
fightingnuns: posts big blind $4
*** HOLE CARDS ***
Dealt to fightingnuns [6h 5c]
Najammq: folds 
Uncalled bet ($2) returned to fightingnuns
fightingnuns collected $4 from pot
fightingnuns: doesn't show hand 
*** SUMMARY ***
Total pot $4 | Rake $0 
Seat 1: fightingnuns (big blind) collected ($4)
Seat 2: Najammq (button) (small blind) folded before Flop



PokerStars Game #59732068989:  Hold'em No Limit ($2/$4 USD) - 2011/03/24 15:36:23 ET
Table 'Thekla IX' 2-max Seat #1 is the button
Seat 1: fightingnuns ($219.50 in chips) 
Seat 2: Najammq ($188.50 in chips) 
fightingnuns: posts small blind $2
Najammq: posts big blind $4
*** HOLE CARDS ***
Dealt to fightingnuns [Kd Kc]
fightingnuns: raises $4 to $8
Najammq: folds 
Uncalled bet ($4) returned to fightingnuns
fightingnuns collected $8 from pot
fightingnuns: doesn't show hand 
*** SUMMARY ***
Total pot $8 | Rake $0 
Seat 1: fightingnuns (button) (small blind) collected ($8)
Seat 2: Najammq (big blind) folded before Flop



PokerStars Game #59732076511:  Hold'em No Limit ($2/$4 USD) - 2011/03/24 15:36:30 ET
Table 'Thekla IX' 2-max Seat #2 is the button
Seat 1: fightingnuns ($223.50 in chips) 
Seat 2: Najammq ($184.50 in chips) 
Najammq: posts small blind $2
fightingnuns: posts big blind $4
*** HOLE CARDS ***
Dealt to fightingnuns [7h 4d]
Najammq: raises $4 to $8
fightingnuns: folds 
Uncalled bet ($4) returned to Najammq
Najammq collected $8 from pot
*** SUMMARY ***
Total pot $8 | Rake $0 
Seat 1: fightingnuns (big blind) folded before Flop
Seat 2: Najammq (button) (small blind) collected ($8)



PokerStars Game #59732087853:  Hold'em No Limit ($2/$4 USD) - 2011/03/24 15:36:40 ET
Table 'Thekla IX' 2-max Seat #1 is the button
Seat 1: fightingnuns ($219.50 in chips) 
Seat 2: Najammq ($188.50 in chips) 
fightingnuns: posts small blind $2
Najammq: posts big blind $4
*** HOLE CARDS ***
Dealt to fightingnuns [9h Kd]
fightingnuns: raises $4 to $8
Najammq: folds 
Uncalled bet ($4) returned to fightingnuns
fightingnuns collected $8 from pot
fightingnuns: doesn't show hand 
*** SUMMARY ***
Total pot $8 | Rake $0 
Seat 1: fightingnuns (button) (small blind) collected ($8)
Seat 2: Najammq (big blind) folded before Flop



PokerStars Game #59732095514:  Hold'em No Limit ($2/$4 USD) - 2011/03/24 15:36:47 ET
Table 'Thekla IX' 2-max Seat #2 is the button
Seat 1: fightingnuns ($223.50 in chips) 
Seat 2: Najammq ($184.50 in chips) 
Najammq: posts small blind $2
fightingnuns: posts big blind $4
*** HOLE CARDS ***
Dealt to fightingnuns [4h 2c]
Najammq: raises $4 to $8
fightingnuns: folds 
Uncalled bet ($4) returned to Najammq
Najammq collected $8 from pot
*** SUMMARY ***
Total pot $8 | Rake $0 
Seat 1: fightingnuns (big blind) folded before Flop
Seat 2: Najammq (button) (small blind) collected ($8)



PokerStars Game #59732109812:  Hold'em No Limit ($2/$4 USD) - 2011/03/24 15:37:00 ET
Table 'Thekla IX' 2-max Seat #1 is the button
Seat 1: fightingnuns ($219.50 in chips) 
Seat 2: Najammq ($188.50 in chips) 
fightingnuns: posts small blind $2
Najammq: posts big blind $4
*** HOLE CARDS ***
Dealt to fightingnuns [Kh 9s]
fightingnuns: raises $4 to $8
Najammq: raises $20 to $28
fightingnuns: calls $20
*** FLOP *** [4c 5h Ah]
Najammq: bets $32
fightingnuns: calls $32
*** TURN *** [4c 5h Ah] [3h]
Najammq: checks 
fightingnuns: checks 
*** RIVER *** [4c 5h Ah 3h] [2d]
Najammq: checks 
fightingnuns: bets $80
Najammq: calls $80
*** SHOW DOWN ***
fightingnuns: shows [Kh 9s] (a straight, Ace to Five)
Najammq: shows [Tc Ad] (a straight, Ace to Five)
Najammq collected $139.75 from pot
fightingnuns collected $139.75 from pot
*** SUMMARY ***
Total pot $280 | Rake $0.50 
Board [4c 5h Ah 3h 2d]
Seat 1: fightingnuns (button) (small blind) showed [Kh 9s] and won ($139.75) with a straight, Ace to Five
Seat 2: Najammq (big blind) showed [Tc Ad] and won ($139.75) with a straight, Ace to Five



PokerStars Game #59732175084:  Hold'em No Limit ($2/$4 USD) - 2011/03/24 15:38:01 ET
Table 'Thekla IX' 2-max Seat #2 is the button
Seat 1: fightingnuns ($219.25 in chips) 
Seat 2: Najammq ($188.25 in chips) 
Najammq: posts small blind $2
fightingnuns: posts big blind $4
*** HOLE CARDS ***
Dealt to fightingnuns [8s Kc]
Najammq: folds 
Uncalled bet ($2) returned to fightingnuns
fightingnuns collected $4 from pot
fightingnuns: doesn't show hand 
*** SUMMARY ***
Total pot $4 | Rake $0 
Seat 1: fightingnuns (big blind) collected ($4)
Seat 2: Najammq (button) (small blind) folded before Flop



PokerStars Game #59732183361:  Hold'em No Limit ($2/$4 USD) - 2011/03/24 15:38:08 ET
Table 'Thekla IX' 2-max Seat #1 is the button
Seat 1: fightingnuns ($221.25 in chips) 
Seat 2: Najammq ($186.25 in chips) 
fightingnuns: posts small blind $2
Najammq: posts big blind $4
*** HOLE CARDS ***
Dealt to fightingnuns [6c 4c]
fightingnuns: raises $4 to $8
Najammq: folds 
Uncalled bet ($4) returned to fightingnuns
fightingnuns collected $8 from pot
fightingnuns: doesn't show hand 
*** SUMMARY ***
Total pot $8 | Rake $0 
Seat 1: fightingnuns (button) (small blind) collected ($8)
Seat 2: Najammq (big blind) folded before Flop



PokerStars Game #59732192677:  Hold'em No Limit ($2/$4 USD) - 2011/03/24 15:38:17 ET
Table 'Thekla IX' 2-max Seat #2 is the button
Seat 1: fightingnuns ($225.25 in chips) 
Seat 2: Najammq ($182.25 in chips) 
Najammq: posts small blind $2
fightingnuns: posts big blind $4
*** HOLE CARDS ***
Dealt to fightingnuns [8c 5s]
Najammq: raises $4 to $8
fightingnuns: folds 
Uncalled bet ($4) returned to Najammq
Najammq collected $8 from pot
*** SUMMARY ***
Total pot $8 | Rake $0 
Seat 1: fightingnuns (big blind) folded before Flop
Seat 2: Najammq (button) (small blind) collected ($8)



PokerStars Game #59732202690:  Hold'em No Limit ($2/$4 USD) - 2011/03/24 15:38:26 ET
Table 'Thekla IX' 2-max Seat #1 is the button
Seat 1: fightingnuns ($221.25 in chips) 
Seat 2: Najammq ($186.25 in chips) 
fightingnuns: posts small blind $2
Najammq: posts big blind $4
*** HOLE CARDS ***
Dealt to fightingnuns [Ac 5d]
fightingnuns: raises $4 to $8
Najammq: calls $4
*** FLOP *** [Qd 4d Ad]
Najammq: checks 
fightingnuns: bets $12
Najammq: calls $12
*** TURN *** [Qd 4d Ad] [3c]
Najammq: checks 
fightingnuns: checks 
*** RIVER *** [Qd 4d Ad 3c] [Kd]
Najammq: checks 
fightingnuns: bets $24
Najammq: folds 
Uncalled bet ($24) returned to fightingnuns
fightingnuns collected $39.50 from pot
fightingnuns: doesn't show hand 
*** SUMMARY ***
Total pot $40 | Rake $0.50 
Board [Qd 4d Ad 3c Kd]
Seat 1: fightingnuns (button) (small blind) collected ($39.50)
Seat 2: Najammq (big blind) folded on the River



PokerStars Game #59732251093:  Hold'em No Limit ($2/$4 USD) - 2011/03/24 15:39:11 ET
Table 'Thekla IX' 2-max Seat #2 is the button
Seat 1: fightingnuns ($240.75 in chips) 
Seat 2: Najammq ($166.25 in chips) 
Najammq: posts small blind $2
fightingnuns: posts big blind $4
*** HOLE CARDS ***
Dealt to fightingnuns [4d Qd]
Najammq: folds 
Uncalled bet ($2) returned to fightingnuns
fightingnuns collected $4 from pot
fightingnuns: doesn't show hand 
*** SUMMARY ***
Total pot $4 | Rake $0 
Seat 1: fightingnuns (big blind) collected ($4)
Seat 2: Najammq (button) (small blind) folded before Flop



PokerStars Game #59732259693:  Hold'em No Limit ($2/$4 USD) - 2011/03/24 15:39:19 ET
Table 'Thekla IX' 2-max Seat #1 is the button
Seat 1: fightingnuns ($242.75 in chips) 
Seat 2: Najammq ($164.25 in chips) 
fightingnuns: posts small blind $2
Najammq: posts big blind $4
*** HOLE CARDS ***
Dealt to fightingnuns [Kd 5s]
fightingnuns: raises $4 to $8
Najammq: folds 
Uncalled bet ($4) returned to fightingnuns
fightingnuns collected $8 from pot
fightingnuns: doesn't show hand 
*** SUMMARY ***
Total pot $8 | Rake $0 
Seat 1: fightingnuns (button) (small blind) collected ($8)
Seat 2: Najammq (big blind) folded before Flop



PokerStars Game #59732266523:  Hold'em No Limit ($2/$4 USD) - 2011/03/24 15:39:25 ET
Table 'Thekla IX' 2-max Seat #2 is the button
Seat 1: fightingnuns ($246.75 in chips) 
Seat 2: Najammq ($160.25 in chips) 
Najammq: posts small blind $2
fightingnuns: posts big blind $4
*** HOLE CARDS ***
Dealt to fightingnuns [Tc 6s]
Najammq: raises $4 to $8
fightingnuns: folds 
Uncalled bet ($4) returned to Najammq
Najammq collected $8 from pot
*** SUMMARY ***
Total pot $8 | Rake $0 
Seat 1: fightingnuns (big blind) folded before Flop
Seat 2: Najammq (button) (small blind) collected ($8)



PokerStars Game #59732278439:  Hold'em No Limit ($2/$4 USD) - 2011/03/24 15:39:36 ET
Table 'Thekla IX' 2-max Seat #1 is the button
Seat 1: fightingnuns ($242.75 in chips) 
Seat 2: Najammq ($164.25 in chips) 
fightingnuns: posts small blind $2
Najammq: posts big blind $4
*** HOLE CARDS ***
Dealt to fightingnuns [As 6s]
fightingnuns: raises $4 to $8
Najammq: raises $20 to $28
fightingnuns: folds 
Uncalled bet ($20) returned to Najammq
Najammq collected $16 from pot
*** SUMMARY ***
Total pot $16 | Rake $0 
Seat 1: fightingnuns (button) (small blind) folded before Flop
Seat 2: Najammq (big blind) collected ($16)



PokerStars Game #59732299052:  Hold'em No Limit ($2/$4 USD) - 2011/03/24 15:39:56 ET
Table 'Thekla IX' 2-max Seat #2 is the button
Seat 1: fightingnuns ($234.75 in chips) 
Seat 2: Najammq ($172.25 in chips) 
Najammq: posts small blind $2
fightingnuns: posts big blind $4
*** HOLE CARDS ***
Dealt to fightingnuns [6c 5h]
Najammq: raises $4 to $8
fightingnuns: folds 
Uncalled bet ($4) returned to Najammq
Najammq collected $8 from pot
*** SUMMARY ***
Total pot $8 | Rake $0 
Seat 1: fightingnuns (big blind) folded before Flop
Seat 2: Najammq (button) (small blind) collected ($8)



PokerStars Game #59732308955:  Hold'em No Limit ($2/$4 USD) - 2011/03/24 15:40:05 ET
Table 'Thekla IX' 2-max Seat #1 is the button
Seat 1: fightingnuns ($230.75 in chips) 
Seat 2: Najammq ($176.25 in chips) 
fightingnuns: posts small blind $2
Najammq: posts big blind $4
*** HOLE CARDS ***
Dealt to fightingnuns [6s 5d]
fightingnuns: raises $4 to $8
Najammq: calls $4
*** FLOP *** [Kc 9h 4s]
Najammq: checks 
fightingnuns: bets $12
Najammq: folds 
Uncalled bet ($12) returned to fightingnuns
fightingnuns collected $15.50 from pot
*** SUMMARY ***
Total pot $16 | Rake $0.50 
Board [Kc 9h 4s]
Seat 1: fightingnuns (button) (small blind) collected ($15.50)
Seat 2: Najammq (big blind) folded on the Flop



PokerStars Game #59732327480:  Hold'em No Limit ($2/$4 USD) - 2011/03/24 15:40:22 ET
Table 'Thekla IX' 2-max Seat #2 is the button
Seat 1: fightingnuns ($238.25 in chips) 
Seat 2: Najammq ($168.25 in chips) 
Najammq: posts small blind $2
fightingnuns: posts big blind $4
*** HOLE CARDS ***
Dealt to fightingnuns [3s Jc]
Najammq: raises $4 to $8
fightingnuns: raises $20 to $28
Najammq: folds 
Uncalled bet ($20) returned to fightingnuns
fightingnuns collected $16 from pot
fightingnuns: doesn't show hand 
*** SUMMARY ***
Total pot $16 | Rake $0 
Seat 1: fightingnuns (big blind) collected ($16)
Seat 2: Najammq (button) (small blind) folded before Flop



PokerStars Game #59732345268:  Hold'em No Limit ($2/$4 USD) - 2011/03/24 15:40:39 ET
Table 'Thekla IX' 2-max Seat #1 is the button
Seat 1: fightingnuns ($246.25 in chips) 
Seat 2: Najammq ($160.25 in chips) 
fightingnuns: posts small blind $2
Najammq: posts big blind $4
*** HOLE CARDS ***
Dealt to fightingnuns [4c Ac]
fightingnuns: raises $4 to $8
Najammq: calls $4
*** FLOP *** [6c Jh 7c]
Najammq: checks 
fightingnuns: bets $12
Najammq: folds 
Uncalled bet ($12) returned to fightingnuns
fightingnuns collected $15.50 from pot
fightingnuns: doesn't show hand 
*** SUMMARY ***
Total pot $16 | Rake $0.50 
Board [6c Jh 7c]
Seat 1: fightingnuns (button) (small blind) collected ($15.50)
Seat 2: Najammq (big blind) folded on the Flop



PokerStars Game #59732364741:  Hold'em No Limit ($2/$4 USD) - 2011/03/24 15:40:57 ET
Table 'Thekla IX' 2-max Seat #2 is the button
Seat 1: fightingnuns ($253.75 in chips) 
Seat 2: Najammq ($152.25 in chips) 
Najammq: posts small blind $2
fightingnuns: posts big blind $4
*** HOLE CARDS ***
Dealt to fightingnuns [Qs 3d]
Najammq: raises $4 to $8
fightingnuns: folds 
Uncalled bet ($4) returned to Najammq
Najammq collected $8 from pot
*** SUMMARY ***
Total pot $8 | Rake $0 
Seat 1: fightingnuns (big blind) folded before Flop
Seat 2: Najammq (button) (small blind) collected ($8)



PokerStars Game #59732375336:  Hold'em No Limit ($2/$4 USD) - 2011/03/24 15:41:07 ET
Table 'Thekla IX' 2-max Seat #1 is the button
Seat 1: fightingnuns ($249.75 in chips) 
Seat 2: Najammq ($156.25 in chips) 
fightingnuns: posts small blind $2
Najammq: posts big blind $4
*** HOLE CARDS ***
Dealt to fightingnuns [Kh 4c]
fightingnuns: raises $4 to $8
Najammq: folds 
Uncalled bet ($4) returned to fightingnuns
fightingnuns collected $8 from pot
fightingnuns: doesn't show hand 
*** SUMMARY ***
Total pot $8 | Rake $0 
Seat 1: fightingnuns (button) (small blind) collected ($8)
Seat 2: Najammq (big blind) folded before Flop



PokerStars Game #59732395040:  Hold'em No Limit ($2/$4 USD) - 2011/03/24 15:41:25 ET
Table 'Thekla IX' 2-max Seat #2 is the button
Seat 1: fightingnuns ($253.75 in chips) 
Seat 2: Najammq ($152.25 in chips) 
Najammq: posts small blind $2
fightingnuns: posts big blind $4
*** HOLE CARDS ***
Dealt to fightingnuns [3s Th]
Najammq: raises $4 to $8
fightingnuns: folds 
Uncalled bet ($4) returned to Najammq
Najammq collected $8 from pot
*** SUMMARY ***
Total pot $8 | Rake $0 
Seat 1: fightingnuns (big blind) folded before Flop
Seat 2: Najammq (button) (small blind) collected ($8)



PokerStars Game #59732403867:  Hold'em No Limit ($2/$4 USD) - 2011/03/24 15:41:34 ET
Table 'Thekla IX' 2-max Seat #1 is the button
Seat 1: fightingnuns ($249.75 in chips) 
Seat 2: Najammq ($156.25 in chips) 
fightingnuns: posts small blind $2
Najammq: posts big blind $4
*** HOLE CARDS ***
Dealt to fightingnuns [9s 6s]
fightingnuns: raises $4 to $8
Najammq: folds 
Uncalled bet ($4) returned to fightingnuns
fightingnuns collected $8 from pot
fightingnuns: doesn't show hand 
*** SUMMARY ***
Total pot $8 | Rake $0 
Seat 1: fightingnuns (button) (small blind) collected ($8)
Seat 2: Najammq (big blind) folded before Flop



PokerStars Game #59732431793:  Hold'em No Limit ($2/$4 USD) - 2011/03/24 15:42:00 ET
Table 'Thekla IX' 2-max Seat #2 is the button
Seat 1: fightingnuns ($253.75 in chips) 
Seat 2: Najammq ($152.25 in chips) 
Najammq: posts small blind $2
fightingnuns: posts big blind $4
*** HOLE CARDS ***
Dealt to fightingnuns [8h Ks]
Najammq: raises $4 to $8
fightingnuns: calls $4
*** FLOP *** [Jd Kd 7h]
fightingnuns: bets $12
Najammq: folds 
Uncalled bet ($12) returned to fightingnuns
fightingnuns collected $15.50 from pot
fightingnuns: doesn't show hand 
*** SUMMARY ***
Total pot $16 | Rake $0.50 
Board [Jd Kd 7h]
Seat 1: fightingnuns (big blind) collected ($15.50)
Seat 2: Najammq (button) (small blind) folded on the Flop



PokerStars Game #59732448726:  Hold'em No Limit ($2/$4 USD) - 2011/03/24 15:42:15 ET
Table 'Thekla IX' 2-max Seat #1 is the button
Seat 1: fightingnuns ($261.25 in chips) 
Seat 2: Najammq ($144.25 in chips) 
fightingnuns: posts small blind $2
Najammq: posts big blind $4
*** HOLE CARDS ***
Dealt to fightingnuns [Ah 5s]
fightingnuns: calls $2
Najammq: checks 
*** FLOP *** [8h 6h 7d]
Najammq: checks 
fightingnuns: bets $8
Najammq: calls $8
*** TURN *** [8h 6h 7d] [Ac]
Najammq: checks 
fightingnuns: bets $16
Najammq: folds 
Uncalled bet ($16) returned to fightingnuns
fightingnuns collected $23.50 from pot
fightingnuns: doesn't show hand 
*** SUMMARY ***
Total pot $24 | Rake $0.50 
Board [8h 6h 7d Ac]
Seat 1: fightingnuns (button) (small blind) collected ($23.50)
Seat 2: Najammq (big blind) folded on the Turn
